Only upon the condition – только при условии
Oracle is willing to license – Oracle готов (добровольно) лицензировать
Terms and conditions – ограничения и условия
Limited license grants – ограниченная лицензия предоставляет
License for evaluation purposes – лицензия для определения (оценки) целей
Excerpting brief portions of the specification – выборка (цитирование) коротких частей спецификации
Such excerpts do not in the aggregate constitute a significant portion – такие выдержки в совокупности не составляют значительной части
Distribution of compliant implementations – распространение реализаций, соответствующих техническим условиям
Royalty free – без авторского гонорара (отчислений)
Perpetual license – бессрочная лицензия
The foregoing license is expressly conditioned on you not acting outside its scope – предшествующая (вышеупомянутая) лицензия чётко (прямо, категорически) обуславливает вас не действовать вне её рамок
Servlet API described herein – Servlet API описано здесь
Bench mark – исходные данные; критерий
Particular features – конкретные (частные, редкие) особенности (детали)
To carry out the intention of the specification – выполнить (осуществить) цель спецификации
Compatibility test suite has been provided for assessing - набор для тестирования совместимости предоставлен для оценивания
For resolving questions – для решения вопросов
Final arbiter of such issues – финальный арбитр в таких спорных вопросах
Intended audience for this specification – предназначенная (целевая) публика для этой спецификации
That conform to this standard – которые соответствуют (согласовываются) этому стандарту
Authoring tool developers – создатель инструмента разработчиков
To understand the underlying mechanisms – понять механизмы, лежащие в основе
We emphasize – мы акцентируем внимание (подчёркиваем)
Enterprise – предпринимательство; предприимчивость; инициатива; корпоративный
Relevant to the development – значимый (существенный) для разработки
Digest authentication – сборник материалов по идентификации
Affecting this specification – затрагивающей эту спецификацию
Extensible markup language – расширенный язык разметки (XML)
Deployment descriptor – дискриптор (описатель) развёртывания
Acknowledgement – признательность; благодарность
Insure – страховаться; гарантировать
Negatively impacted – негативно повлияло
Handed off to the Servlet Container – передан в сервлет контейнер
Response is properly flushed – ответ корректно выведен
Proprietary server extensions – патентованные серверные расширения
Must meet additional requirements – должны подходить под дополнительные требования
Only affected – только затронуло
Notion – понятие; идея
Unless – если не; пока не; кроме; за исключением
Extending a class that implements the interface – расширяя (наследуя) класс, который реализует интерфейс
Transient – временный; кратковременный; недолговечный
Brood – размышлять; тяготиться
Blanket – полный; общий; всеохватывающий
Request handling methods – методы обрабатывающие запрос
Routes to an instance of a servlet – направляет к экземпляру сервлета
Concurrent requests – одновременные (параллельные) запросы
Only concern himself with – сам имеет дело (касается, затрагивает) только с
Concern – отношение; касательство; беспокойство
Very familiar with – очень хорошо знакомым с
That employ these features – которые используют (применяют) эти особенности (детали)
Produced by the doGet method – произведённый методом doGet
Servlet container provides instances of the servlet – сервлет контейнер поставляет (предоставляет) экземпляры сервлета
Instantiate multiple instances – создать множество экземпляров
Efficient utilization – эффективное использование
Normal Java class loading facilities – обычные средства загрузки Java класса
Instantiation – создание экземпляра
Persistent configuration data – постоянные (неизменные) данные конфигурации
Costly resources – дорогостоящие ресурсы
One-time activities – единоразовые действия
Must be released by the servlet container – должен быть выведен (освобождён, отпущен) сервлет контейнером
Failed initialization – неудачная инициализация
Unavailability – недоступность; отсутствие
Reveal – открывать; разоблачать; обнаруживать
Respective – соответствующий; соответственный
Retain – сохранять; удерживать в памяти
Alias – прозвище; псевдоним
Will – воля; желание; проявлять волю (желание)
What will he do with it? – что он будет делать с этим?
This will our bus – это наверное наш автобус
Accidents will happen – происшествия могут случаться
Will you tell me the time? – можете вы подсказать мне время?
Retrieve – доставать; извлекать; восстанавливать
Whatever – какой бы ни; любой; что бы ни; независимо от; по любому
Look up – поиск; просмотр; искать; смотреть вверх
Conventional – условный; оговоренный; удовлетворяющий техническим условиям
Explicit – подробный; явный; точный; заключение; конец
Eager – интенсивный; активный
Query – спрашивать; запрашивать; вопрос; запрос
Expose – подвергать действию (опасности); разоблачать
Scope – границы; рамки; дисплей; область видимости
Advice – сообщение; уведомление; совет; рекомендация
Closure – закрытие; смыкание; застёжка
Proceed – продолжать; отправлять; возобновлять
Proceeding – действие; деятельность
Pointcut for binding – точка для связывания (сращивания)
Whereas – тогда как
Crosscutting concerns – комплексные (многоаспектные) отношения
Middleware solutions – межплатформенные решения
Backwards compatible – обратная совместимость
Conviction – убеждение; осуждение
He could not bring himself – он не мог заставить себя
Without having to bring in the rest – без того, чтобы доводить до остального
For persisting your data – для сохранения ваших данных
Full-featured – полнофункциональный
Intrusive – навязчивый
Comprehensive documentation – обширная (всесторонняя) документация
Embrace – объятие; обнимать; охватывать
Opinionated – самоуверенный
Favors convention over configuration – поддерживает договорённость через конфигурацию
Invasive – навязчивый
This capability applies – эта способность применяется
Embedded – внедрённый
Tier – звено; уровень
Composing disparate components – составляя несопоставимые компоненты
Codify – систематизировать
Manner – манера; способ; метод
Maintain – поддерживать
Pose – позировать; излагать; формулировать
Explanatory – толковый; поясняющий
Well-intentioned – исполненный благих намерений
Sophisticated implementation – доработанная (усовершенствованная) реализация
Decouple – развязывать; разъединять
Resource bundles – связывание ресурсов
Focal point – центральная точка
Retrieval – восстановление
Alliance – союз; блок
Method interceptor – метод перехватчик
Incorporate – объединять; включать в состав
Incorporate behavioral information into your code – включить поведенческую информацию в ваш код
Tedious – нудный; скучный
Consistent – последовательный; непротиворечивый; согласующийся
Full-fledged enterprise applications – законченные корпоративные приложения
Wire up – подключать; устанавливать
Reuse – повторное использование
Comprise – включать; содержать
Transitive – переходный; кратковременный
Concatenate – объединять; соединять
Milestone – веха
Mandatory – обязательный
Third-party – сторонняя
Third-party applications support – поддержка приложений третьих фирм
Bill of materials – список материалов
Against – против; напротив; на фоне
Reverse – обратное; противоположное
Notably – в особенности
Allegedly – будто бы; якобы
Establish – учреждать; устанавливать
Established – установленный; принятый; авторитетный; признанный
Bullet – пуля
Integral – цельный; неотъемлемый
Foremost – передовой; самый главный
Thorough – исчерпывающий; всесторонний; совершенный; абсолютный
Treatment – обращение; рассмотрение; трактовка
Mature – зрелый; взрослый; сформировавшийся
Whereby – посредством чего
Hence – отсюда; поэтому; следовательно; таким образом
Assemble – собирать; вызывать
Aforementioned – вышеупомянутый
Standalone applications – отдельные (автономные) приложения
Boilerplate – шаблон; стереотип
Suffice – быть достаточным
Keystroke – нажатие клавиши
Inspect – внимательно осматривать; изучать
Predefined delimiter – предопределённый разделитель
Semicolon – точка с запятой
Reside – пребывать; находиться
Shortage of oversight - недостаточный контроль
Preceding – предшествующий
Convey – передавать (идеи, чувства); выражать
Domain – домен; область
Fine-grain – мелкого уровня
Qualified – знающий; компетентный; пригодный
Qualified class name – полное имя класса
Straightforward – прямой; открытый; честный
Linkage – соединение; взаимосвязь
Solely – единственно; исключительно
Introspection – самоанализ
Autowiring – автоподключение
Container that hosts bean – контейнер, который размещает в себе бин
Can be considered aliases – могут считаться псевдонимами
Enforced – вынужденный; принуждённый
Alphanumeric – буквенно-цифровой
Desirable – желательный; желанный
Accomplish – совершать; выполнять
Clash – коллизия; конфликт; столкновение
Essentially – существенно; по существу
Recipe – рецепт; средство; способ
Acquire – получать; приобретать
That is – то есть
Legacy – функции; наследие
Adhere – придерживаться
Emergency – крайность; чрезвычайное положение
Sombre – мрачный; унылый; безрадостный
Emerge – появляться; возникать
Comprehend – понимать; включать в себя
Subsequently – впоследствии; позже
Ancestor – предок
Parlance – язык; манера говорить
Coherent – связанный; гармоничный; согласованный
Clue – клубок ниток; нить; ход мыслей; раскрыть секрет; информировать
Wrap – завёртывать; охватывать; погружать
Tough – жёсткий; крепкий; трудный; несгибаемый
Sought after – востребованный; популярный
Draft – чек; счёт; набросок; эскиз; отбирать; делать набросок
Wake – просыпаться; бодрствовать; след; последствие
In the wake - в результате
To sack you – уволить тебя
Scare – испуг; паника; пугать
We can scare up – мы можем отыскать
Wheel – колесо; доллар
Reluctant – неохотный; вынужденный; делающий по принуждению
Rack – полка; стойка; напрягать; обдирать; истощать
Backwater – заводь; глухой; заброшенный
Equivocal – двусмысленный; сомнительный; подозрительный
Beg – просить; умолять
Surround – окружать; обступать
Diligent – прилежный; старательный; усердный
Tribute – дань; должное; подношение; награда
Seal – печать; гарантия; доказательство; скреплять печатью; опечатывать
Cease – переставать; прекращаться
Intermediate – промежуточное звено; промежуточный; средний
Awful – страшный; ужасный
Hilarious – весёлый; шумный; оживлённый
Pivot - главный; основной; центровой; опорный; вращаться вокруг оси
Insane - сумасшедший; безумный; безрассудный
Casual - случайный; нерегулярный; неаккуратный; повседневный
Flattery - лесть; подхалимство
Thereby - таким образом; в связи с этим; тем самым
Feverishly - лихорадочно; возбуждённо; взволнованно
Consciousness - сознание; осознание; осознанность
Governor - губернатор; правитель
Injury - травма; рана
Look after - присматривать
Could you look after my cat? - не могли бы вы присмотреть за моим котом?
Get on well - ладить
Get rid of - избавиться
Get through - справиться; сдать экзамен
Be up - случаться; происходить
What's up? - что нового?; что случилось?
Be up for - быть готовым; быть в настроении
I'm always up for new things - я всегда готов к новым вещам
Be up to - намереваться; собираться сделать
He's up to something - он собирается что-то сделать
Run into - налететь; столкнуться
Run away from - избегать; убегать из
Run out - кончаться
She never runs out of ideas - у неё никогда не кончаются идеи
Go by - проходить мимо; пролетать
Go on - продолжать
Retention - удерживание; сохранение; сохранение в памяти
Policy - линия поведения; политика
Stub - заглушка; пень; огрызок
Mock - подделка; фальсификация
Sorority - женский клуб (общество)
Preposterous - абсурдный; нелепый
Consider the following - рассмотрим следующее
In the immediate vicinity - в непосредственной близости
Conceivably - предположительно; возможно; вероятно
Commotion - беспорядки; суета; суматоха
Cautionary Tale - поучительный рассказ
Betray - изменять; предавать
Gospel - евангелие; назидание; наставление
Were castigated by name - были подвергнуты критике поимённо
Neglect - пренебрежение; игнорирование; пренебрегать; игнорировать
Suggestion - предложение; совет
Deplorable situation - плачевная ситуация
Remedy - средство; лекарство; исправлять
Agitate - волновать; возбуждать
Bitter - горький; ожесточённый
Gust of wind - порыв ветра
Plausible - правдоподобный; похожий на правду
Boyish - мальчишеский; радостный
Click - щелчок; щёлкать
Recycling code - код повторного использования
Borrow - занимать; одалживать
Junction - связывание; соединение
Wane - спад; упадок; удти на убыль; уменьшаться
Strike - ударять; наносить удар; атаковать; поражать
Presumably - предположительно; возможно; вероятно
Short-cut - кратчайший путь
Apt - годный; подходящий; соответствующий
I've driven myself - я загнал себя
Speck - пятно; пятнышко; точка
Withdraw - забирать; отзывать; ретироваться; уходить
Burden - бремя; ноша; груз; тяжесть
Ponder - обдумывать; взвешивать; размышлять
Horrific - ужасающий
Aware - знающий; осведомлённый
All-absorbing - всепоглощающий; захватывающий
Encounter - случайная встреча; первый опыт (знакомство); столкновение
Petite - маленькая; изящная
Perplex - ставить в тупик; запутывать
Perplexing - трудный; озадачивающий
One more detail - ещё одна деталь
Vehicle - транспортное средство; автомобиль
Seep - просачиваться; проникать
Midget - миниатюрный; карлик
Complain - жаловаться
Deduct - вычитать; отнимать
Intently - пристально; внимательно
Unquestionable - бесспорный; несомненный
Envelop - обёртывать
above all - прежде всего; превыше всего
after all - после всего (в конце концов)
and all - и всё такое
and so on - и так далее
and so forth - и так далее
as a matter of fact - собственно говоря; на самом деле
as things stand now - при текущем положении дел
as things turned out - как оказалось
as to - что касается
as for - что касается
at a glance - с первого взгляда
at any rate - во всяком случае
at first - во-первых
at least - по крайней мере
believe it or not - веришь или нет
by the way - кстати
deep down - в глубине души; на самом деле
first of all - прежде всего
for all that - за всё, что
for example - например
for instance - например
for one thing - например; первым делом
for one's part - что касается конкретного человека
on one's part - что касается конкретного человека
for the most part - вообще; по большей части
I dare say - осмелюсь сказать
I wonder - мне интересно
if I remember rightly - если я правильно помню
if I'm not mistaken - если я не ошибаюсь
in a nutshell - вкратце
in all probability - по всей вероятности
in all likelihood - по всей вероятности
in any case - в любом случае
in any event - в любом случае
in fact - на самом деле
in my opinion - по моему мнению
In other words - другими словами
in short - короче
in brief - короче
in a word - короче
in the long run - в конечном счёте
it turned out that - оказалось, что
just for the record - только для записи (для справки, скажу сразу)
lay it on the line - говорить начистоту
let alone - не говоря уж о
look here - послушай
needless to say - нет нужды говорить
not to mention - не говоря уж о том
on the contrary - наоборот
one way or another - так или иначе
or what? - или как?
or whatever - или что-то ещё
something tells me - что-то мне подсказывает
that is to say - иначе говоря
that's flat - это окончательно (решение)
that's the way things are going - вот как дела обстоят
to one's mind - на чей-то взгляд
to say nothing of - не говоря уж о
to say the truth - по правде сказать
to sum it up - подводя итог
what's more - кроме того
as is known - как известно
as you know - как вам известно
as was pointed - как было отмечено
besides - кроме того
evidently - очевидно
fortunately - к счастью
unfortunately - к несчастью
frankly speaking - откровенно говоря
honestly speaking - честно говоря
in the first instance - в первую очередь
I see - я понимаю
I think - я думаю
it seems - кажется
maybe - может быть
namely - а именно
no doubt - без сомнения
without doubt - без сомнения
so - так; итак
they say - говорят
to be more exact - точнее говоря
to begin with - начнем с
well - ну; итак
you see - понимаете?
Blank - белый; пустой; чистый
Ballpoint - шариковая ручка
Clip - скрепка; зажим
Meddle - заниматься; интересоваться; вмешиваться
Cubby hole - уютное местечко
Excruciating - мучительный
Bore - скучное занятие; скука; надоедать
Spacious - обширный; просторный
Impeccable - безупречный
Undercover - секретный; тайный
Theft - воровство; грабёж; кража
Secrecy - тайна; загадка; секрет
Commission - доверенность; полномочие; указание; поручение
Conjure - молить; заклинать; заниматься колдовством
Conjure up - наколдовать
Relent - уступать; сдаваться
Odd - нечётный; непарный; случайный; странный
Generous - великодушный; благородный; щедрый
Faculty - дар; способность; власть; право
Despise - презирать
Despite - злоба; злость; презрение; хотя; несмотря на; вопреки
Owe - владеть; обладать; быть обязанным
Twiddle - вертеть; крутить; бездельничать
Invariable - неизменный; постоянный
Give up - оставить; отказаться; бросить; сдаться
Self-imposed - возложенный на самого себя
Impose - класть; помещать; возлагать
Exile - изгнание; ссылка
Circus - цирк
As far as - поскольку; насколько; что касается; дальше
Concerned - заинтересованный; затронутый; увлечённый; участвующий
Appease - успокаивать
Rule out - вычёркивать; исключать
Incontrovertible - бесспорный; неопровержимый
Massacre - бойня; избиение
Chasing - погоня; преследование
Dejected - грустный; печальный; подавленный
Baseless - беспочвенный; необоснованный
Wage - зарплата; оклад
To wage war - вести войну
Abandon - покидать; оставлять; сдавать
Gleeful - весёлый; радостный
Jealous - ревнивый
Prodigy - предзнаменование; чудо; чудовище
Marvel - чудо; диво; изумляться; удивляться
Dumping - сваливание; сбрасывание
Credible - вероятный; правдоподобный; заслуживающий доверия; надёжный
As long as - пока; до тех пор пока
Just like that - вот так просто; ни с того ни с сего
Shred - клочок; кусок; обрывок; разрезать; рвать на клочки
Stack - груда; куча; масса; складывать; собирать
Frown - хмурый взгляд; хмурить брови
Consequence - последствие; результат; вывод; заключение
Lonely - одинокий
Lodging - жилище; жильё; сдаваемая комната
Quarters - жилище; жильё; квартира
Modest - скромный; сдержанный
Hallway - коридор; проход; прихожая
Caretaker - смотритель; сторож
Cupboard - буфет; сервант
Wardrobe - гардероб; шкаф
Bucket - ведро
Insist - настаивать; настойчиво утверждать
Superintend - заведовать; руководить; присматривать; надзирать
Poke - толчок; пинок; совать; пихать
Poke around - высматривать; выискивать
Air-tight - воздухонепроницаемый; без слабых мест
Miserably - печально; жалко; прискорбно; весьма; очень; сильно
Draught - сквозняк
Painter - живописец; художник
Kitschy - вульгарный
Eccentric - эксцентричный
Obligatory - непременный; обязательный
Estate - поместье; имение
Footprint - след; отпечаток
Recluse - затворник; отшельник
Detestable - отвратительный; мерзкий
Scoundrel - негодяй; мерзавец; подлец
Vain - напрасный; бесполезный; тщеславный; самодовольный
Left to my own devices - предоставленный самому себе
Flighty - непостоянный; изменчивый; ветренный
Shrewd - пронизывающий; проницательный; сообразительный
Ferret out - вынюхивать; разведывать
Regardless - невнимательный
Lease - аренда; сдавать в аренду
Merely - только; просто; единственно
Magnificent – великолепный
Trade – сделка
Dwelling - жилище
Dusk - сумрак; сумерки
Owl - сова
I'm at your disposal – я в вашем распоряжении
Timid – робкий
Sensible - здравомыслящий
Postponement – откладывание; отсрочка
Breach – нарушение; разрыв отношений
Crow - ворона
Scarecrow – чучело
Advertise – рекламировать
Advertisement - реклама
Albeit - хотя
Caching - кэширование
Chattering – болтовня
Sheepish – глуповатый
Countryside – сельская местность
Forsooth – поверь
Plug – штекер
Slight – незначительный
Hassle – стычка
Rebel – бунтарь; воспротивиться
Briskly – оживлённо
Overflowing – переполненный
Lit up – зажигать
Handle – рукоятка; удобный случай; возможность; повод; предлог; управлять; справляться; заведовать; контролировать; ухаживать 
Hailed – расценена
Ascertain – выяснять
Curt – односложный
Muted – приглушённый
Extent – степень
Apparently – по всей видимости
Eerily – устрашающе
Orderly – упорядоченный
Conversely – наоборот
Further - дальнейший; продолжающийся; затем; более того; продвигать; содействовать; способствовать
Furthermore - к тому же; более того; кроме того
Moreover - сверх того; кроме того
Therefor - из-за этого; поэтому
Consequently - следовательно; в результате
Thus - таким образом; соответственно
Thereupon - на этой основе; вследствие того; в этой связи
Submit - подчинять; покорять; подчиняться; покоряться; представлять на рассмотрение; предлагать; доказывать; утверждать; подтверждать
Fork – вилка; развилка; разветвляться
Utter – полный; выговорить
Alertness – настороженность
Fraction – доля
Back of beyond – глушь
Scalding – обжигающий
Slightest – малейшее
Prompt – подсказка; напоминание; подсказывать
Carry out – выполнять; совершать
Along the way – по пути
Proper – правильный
Assure – уверять
Possession – владение
Possessions – пожитки
Relapse – рецидив
Stuck – застрял
Come over! – Присоединяйся!
To object – возражать
Furtive – вороватый
Rush – порыв
Delinquent – правонарушитель
Misgiving – опасение
Similarly – так же; подобным образом
Comparable – сопоставимый; соизмеримый
In the same way – тем же способом
Likewise – подобно; так же
As well – так же
As well as – так же как
Equally – равно; одинаково; в равной степени
On the whole – в целом
To be sure – конечно
Gulf – морской залив; бездна; пропасть
Traverse – прохождение; проходить; пересекать
Invoked procedure – вызываемая процедура
Invoking instruction – команда запроса
Invoke – просить; запрашивать
Handling – управление; обработка
Authority – власть; полномочие; авторитет
Nevertheless – всё таки; тем не менее
Even so – даже так; даже при этих условиях
At the same time – в тот же раз
Though – хотя; даже; если бы; хотя бы; тем не менее; однако
Meanwhile – тем временем; между тем
Meantime – тем временем; между тем
In the mean time – тем временем; между тем
Thereafter – после этого; впоследствии
Currently – теперь; в настоящее время; ныне
Nearby – ближний; ближайший; соседний
Polling – голосование; опрашивание
Fiction - выдумка; фантазия; художественная литература
Science fiction – фантастика
Stunning – оглушающий; ошеломляющий; сногшибательный
Tasty - вкусный; изящный; приятный
Persistence – постоянство; настойчивость
Colocation – совместное размещение
Revert – возвращаться
Fetch – принести; достать
Bunch – связка; пачка
Descriptive – описательный; дескриптивный; наглядный
Collaborate – работать совместно; сотрудничать
Notify – извещать; уведомлять
Pending – незаконченный; ожидающий решения
Genre – жанр
Annoy – досаждать; раздражать; надоедать
Annoyed – раздражённый; раздосадованный
Anon – скоро; вскоре; в скором времени
Cope – справиться; совладать
Fairy – фея; волшебница; волшебный; сказочный
Fairy tale – волшебная сказка
Quarrel – ссора
Brink – край; берег; грань
On the brink – на краю; на грани
Routine – обычный порядок; рутина; типовой; стандартный; шаблонный
Clause – статья; пункт; условие; оговорка
Implicit – скрытый; неявный; подразумеваемый
Prohibition – запрет
Exhibit – экспонат; показ; выставка; показывать; выставлять
Afterward – впоследствии; позже
Nerd – тупица; зануда; ботаник
Disruption – разрушение
Rescue – спасение; избавление; освобождение
Weird – рок; судьба; роковой; странный; непонятный
Training – воспитание; обучение; тренировка; стажировка
Picking up – выбор; подбор
Empower – давать возможность; разрешать; оказывать поддержку; уполномочивать
Energizing – активация; включение; возбуждение
Exhilarate – веселить; развлекать; подбодрять; воодушевлять
Awaken – пробуждаться; просыпаться
Practicing – практикующий
Practice – практика; привычка
Awesome – ужасный; чудовищный; необычайный; удивительный
Lay off – увольнение; приостановка деятельности; увольнять
Drain – вытекание; вытекать; высыхать; оттекать
Overdrive – изматывать; изнурять
Frantically – безумно; неистово; яростно
Majority – большинство
Involve – втягивать; вовлекать; погружаться
Due – должное; должный; надлежащий; ожидаемый
Sort out – рассортировать; выяснить
Crisis mode – кризисный режим; аврал
Superficial – внешний; поверхностный; кажущийся; мнимый
One-off – одноразовый
Obstacle – помеха; преграда; препятствие
Imperative – повеление; приказ; распоряжение
Inspire – вдохновлять; воодушевлять; внушать; побуждать
Undergo – испытывать; переносить; подвергаться
Powerful – мощный; сильный
Joy – радость; восторг; удовольствие
Guise – внешний вид; наружность; видимость; маска
Relentless – безжалостный; жестокий; непреклонный
Painful – мучительный; болезненный
Downsize – сокращать
Go all out – напрячь все силы
Recognized – признанный; общепризнанный; очевидный; явный
Usage – применение; использование; обычай; традиция
Spot – пятно; капля; место
Reinforce – укреплять; усиливать
Overwhelm – ошеломлять; поражать; подавлять; сокрушать
Instill – прививать; насаживать
Embark – начинать; вступать
Conducive – благоприятный; подходящий
Rally – объединение; сплочение; сбор; ралли
Mindset – образ мысли; тип мышления
Growth – развитие; рост
Bring out – показывать; выявлять; обнаруживать
Accountable – подотчётный; ответственный
Inclusive – включающий
Fabulous – потрясающий; изумительный; ошеломительный; легендарный
Outset – начало; начинание
Engage – вовлекать; принуждать; заставлять; быть занятым
Solicit – просить; умолять; запрашивать; требовать
Bold – отважный; храбрый
Pivotal – центральный; осевой; основной
Handsome – красивый; статный; любезный; обходительный
Prudent – благоразумный; разумный; рассудительный; бережливый
Stumble – спотыкаться; оступаться
Marvellous – изумительный; удивительный
Amusing – забавный; занятный; занимательный
Peculiar – специфический; особенный; своеобразный; эксцентричный
Boring – надоедливый; скучный
Dull – тупой; глупый; скучный; занудный
Rude – грубый; необработанный; резкий; оскорбительный
Outfit – снаряжение; экипировка; одежда; наряд
I am gonna – я собираюсь (что то делать)
Complicate – затруднять; усложнять
Complicated – сложный; запутанный
To face – смотреть в лицо; сталкиваться лицом к лицу
Chores – рутинные операции; ежедневные обязанности (работа)
Errant – рассеянный; блуждающий; заблудившийся
Run errants – бегать по делам
Jam – сжатие; зажатие; давка; пробка; джем
Mood – настроение; расположение духа
If I'm still Ok with this, we'll do that – если я буду в порядке, мы сделаем это
Break a leg! – ни пуха ни пера!
Humiliation – унижение
Journey – путешествие; поездка
For the sake of – ради (чего-то)
For God sake! – ради Бога!
Give it a shot! – попробуй!
Crack – треск; хруст; трещина; разламывать
Have a crack! – попробуй!; сделай попытку!
Have a go! – попробуй!; сделай попытку!
To have a fight over something – ссориться из-за чего-то
Connotation – подтекст; скрытый смысл
Connote – ассоциироваться; подразумевать
connotate – ассоциироваться; подразумевать
Jerk – резкое движение; толчок; ничтожество; сопляк
Moron – идиот
Embarrassment – затруднение; помеха; замешательство; смущение
Embarrass – затруднять; мешать; сбивать с толку; смущать
Uneasy – неудобный; беспокойный; тревожный; неловкий; скованный
Queer – странный; необычный; чудной
seem – казаться; выглядеть; представляться
Scarcely – едва; почти не; вряд ли
Adorable – обожаемый; восхитительный; очаровательный
Worship – поклонение; почитание; культ
Spatial – пространственный
Aesthetic – эстетичный
Thrill – возбуждение; нервная дрожь; трепет
Thrilled – взволнованный; возбуждённый
Let's take a look at – давайте посмотрим на
A tiny bit – чуть-чуть
Just a little – только чуть-чуть
Substantially – существенно; главным образом; по существу
Overuse – чрезмерное использование; злоупотребление
Eligible – пригодный; приемлемый
Precedence – предшествование; первенство
Pollute – загрязнять; пачкать; портить
Issue – исход; выход; выпуск; публикация; вопрос; проблема
To issue – выходить; исходить; выпускать; иметь результатом
Recurring – периодический; повторяющийся; рекуррентный
Prerequisite – предпосылка; предварительное условие
Consistency – логичность; последовательность; связность
Pop-up – всплывающий; выскакивающий
Obey – подчиняться; повиноваться
Placeholder – местозаполнитель
Underscore – акцентировать; подчёркивать
Ambiguity – двусмысленность; неопределённость
Rely – полагаться; надеяться; зависеть
Enhance – увеличивать; усиливать; улучшать
Versatile – многосторонний; многоцелевой; универсальный
Incur – подвергаться; навлекать на себя; влезать
Drawback – недостаток; препятствие
Mingle – смешиваться
Recognize – распознавать; узнавать; осознавать; постигать
Heterogeneous – неоднородный; разнотипный
Outcome – исход; итог; результат
Acquaintance – знакомство
Spell – заклинание; чары; произносить; писать по буквам
Attend – посещать; присутствовать; уделять внимание; заботиться
Fluently – бегло; легко; без труда
Proficient – искусный; опытный; умелый; знаток; мастер
Cosy – уютный; удобный
Conveniences – удобства
Superfluous – излишний; чрезмерный; избыточный
Study – учёба; изучение; исследование; кабинет
Nursery – детская комната; питомник; рассадник
Erasure – стирание; уничтожение
Vulnerable – уязвимый; ранимый
Preliminary – предварительное, подготовительное мероприятие
Wildcard – групповой символ
Tuple – запись
Cardinality – количество элементов множества
Invoice – счёт
Is everything OK? – всё в порядке?
That would be better – это было бы лучше
Anything else? – что-нибудь ещё?
Income – доход; прибыль; заработок
Expense – затраты; расход; стоимость; цена
Ignition – прожиг; зажигание
Ultimately - в конечном счёте; конечно; ясно; разумеется
Responsibility - ответственность; обязательство
Prospective - будущий; ожидаемый; предполагаемый
Obligate - обязывать; заставлять; принуждать
On behalf of - от лица; от имени кого-то
In behalf of - ради; в пользу; в защиту кого-то
Assume - допускать; предполагать; принимать; брать на себя
Then you won't have any problems - тогда у тебя не будет никаких проблем
What would you recommend? - что бы ты порекомендовал?
It depends on your needs - это зависит от ваших потребностей
Why not? – почему нет?
Afford – давать; доставлять; позволить себе
What can I do for you? - что могу я сделать для вас?
millennium - тысячелетие
minuscule - очень маленький
miscellaneous - смешанный; разнообразный
pageant - маскарад; шоу; спектакль
poignant - острый; резкий; проницательный
priggish - педантичный; скрупулёзный; самодовольный
enigma - головоломка; загадка
elicit - извлекать; выявлять; делать вывод; устанавливать
ecstasy - экстаз; экстази; исступлённый восторг
conscientious - добросовестный; сознательный; честный
misanthrope - человеконенавистник
malicious - злобный; злой
reminiscence - мемуары; воспоминания
itinerary - курс; маршрут; путь
savvy - сообразительность; находчивость
liaison - контакт; связь; посредник
lose - терять; утрачивать; лишаться
loose - свободный
privilege - привилегия; преимущество
crowd - толпа
congratulate - поздравлять
amnesty - амнистия; помилование
plague - мор; чума; досаждать; изводить; надоедать
perpetual - бесконечный; вечный; бессрочный
willful - упрямый; своевольный; сознательный; умышленный
wilful - упрямый; своевольный; сознательный; умышленный
whine - жалоба; хныканье; скулить; жаловаться
cachet - печать
connoisseur - знаток; специалист; эксперт; ценитель
rhythmical - ритмичный; равномерный
nocturnal - ночной
forfeit - расплата; штраф; конфискация
haemorrhage - кровотечение; кровоизлияние
hemorrhage - кровотечение; кровоизлияние
harass - беспокоить; волновать; надоедать; утомлять
hypocrisy - лживость; лицемерие; фальш
temperamental - живой; темпераментный; страстный
dexterity - ловкость; быстрота; сноровка; сообразительность
dye - краска; окраска
stature - рост
diminutive - уменьшительный; маленький; крохотный
councilor - консультант; советник
condescend - снисходить; удостаивать
camouflage - камуфляж; маскировка
criticize - критиковать
quixotic - донкихотский; идеалистичный
obscure - тёмный; неясный; затемнять; скрывать
illuminate - освещать; разъяснять
prevalent - распространённый; общепринятый
prejudice - предрассудок; предубеждение
pursue - преследовать
pronunciation - произношение; акцент
hurl - бросать; швырять
insult - повреждение; кровоизлияние; оскорбление
vicious - порочный; злой
vengeance - месть; мщение
legitimate - законный; легальный; легитимный
definitely - определённо; точно; явно
heinous - гнусный; отвратительный
youthful - молодой; юный; юношеский
yielding - податливый; уступчивый
gauge - мера; масштаб; шаблон; эталон
excessive - чрезвычайный; чрезмерный
prolifically - обильно; в изобилии
asterisk - звёздочка
fiance - жених; невеста
synonymous - синоним
accused - обвиняемый
sacrilegious - кощунственный
reincarnation - реинкарнация
admire - любоваться; восторгаться
fascinate - восхищать; пленять; очаровывать
psychology - психология
stationery - канцелярские товары
statutory - установленный; предписанный
sincerely - честно; искренне; прямо; полностью; целиком
sanctuary - святилище
carnivorous - плотоядный
existence - существо; существование
dilemma - дилемма; затруднительное положение
discipline - дисциплина; обучение; тренировка
idiosyncrasy - индивидуальная особенность; гиперчувствительность; аллергия
possess - владеть; иметь; обладать
reference - связь; ссылка; справка; отношение; касательство
flabbergast - изумлять; поражать; удивлять
would-be - потенциальный; вероятный; возможный
nuisance - досада; неприятность; неудобство; помеха
indispensable - обязательный; важный; необходимый
irresponsible - безответственный; несостоятельный
disappointing - неутешительный; разочаровывающий
disappoint - разочаровывать; расстраивать планы
maneuver - манёвр
manoeuvre - манёвр
susceptable - чувствительный
spontaneous - спонтанный; самопроизвольный
supersede - заменять; вытеснять
sophomore - второкурсник
unanimous - единогласный
devious - удалённый; уединённый; заблудший
fictitious - выдуманный; нереальный; поддельный; фальшивый
plagiarism - плагиат
pity – жалость; сожаление; печальный факт
I'd love to – с удовольствием
fond – любящий; нежный
tremendous – жуткий; страшный; ужасный; потрясающий
suspension – прекращение; приостановка
Hello! - привет!
Hi! - привет!
Hey! - привет!
How are you? - как дела?; как ты?
How are you doing? - как твои дела?
Hi, there! - привет там!
I'm good, thanks! Yourself? - я в порядке, спасибо! как сам?
I'm fine, thank you! - у меня всё хорошо, спасибо!
Nothing much – ничего особенного
How's your wife? - как твоя жена?
How's Kate? - как Кэти?
She's been ill lately, but she's getting better now - она была больна недавно, но ей начинает становиться лучше сейчас
Not bad – не плохо
How's your job? - как твоя работа?
It's good! Thanks for asking - она (работа) в порядке! спасибо что спрашиваешь
What's new? – что нового?
I've got news for you - у меня есть новости для тебя (результат)
I've just got a new job - я только-что получил новую работу (результат)
That's great! - это отлично!
I just got a promotion at work - я только-что получил продвижение на работе
get a promotion – получить продвижение
get a raise – получить повышение зарплаты
bump up – повысить в должности
They bump me up to Java Senior - они повышают меня до Java Senior
So, how is it? – ну, и как она?
It pays more than my last job – она (работа) платит больше, чем моя прошлая работа
It's been ages since, I last saw you - это было очень давно, когда я в прошлый раз видел тебя
It is so good to see you! - так приятно видеть тебя!
It's been a long time! How've you been? - это было так давно (когда я видел тебя)! Как поживаешь?
I haven't seen you around lately. Where have you been? - я не видел тебя в последнее время. где ты был?
Gosh! – Боже!
Is that you? – ты ли это?
You look great! - ты выглядишь отлично!
You haven't changed a bit! – ты не изменился ни чуть!
Neither have you! – ты тоже не изменился!
What's been happening in your life? - что произошло в твоей жизни?
Not much has been going on – ничего особенного не произошло
Same old, same old – всё по старому
I'm in a bit of a rush right now – я немного спешу прямо сейчас
How about we go out for a drink some night? - как насчёт пойти выпить как-нибудь ночью?
What do you say? - что скажешь?
Sounds good! - звучит хорошо!
Make a time – назначить время
I just got back from – я только что вернулся из
What did you do there? – что ты там делал?
How was it? – как это было?
Conjunction – связывание; сцепление; соединение
Resolve – намерение; решимость; решение; разрешение; урегулирование; решать; разрешать; урегулировать
Where are you from? - откуда ты?
Is this your first time here? - это твой первый раз здесь?
How long will you be here? - как долго будешь ты находиться здесь?
How long will you stay here? - как долго будешь ты находиться здесь?
Where are you staying? - где ты остановился?
What's your name? – как твоё имя?
What's yours? - а как твоё имя?
How about you? - как насчёт тебя?
I've been there once - я был там однажды
I've been here a couple of times - я был здесь пару раз
It was nice chatting with you – было приятно поболтать с тобой
I've got to get going now – мне пора идти сейчас
I like it a lot - мне это очень нравится
I like it very much - мне это нравится очень сильно
Are you here by yourself? - ты здесь одна?
Are you here alone? - ты здесь одна?
Resort – прибежище; курорт
Business convention – бизнес конференция
Where did you learn it? - где ты изучил это?
To book tickets – заказать билеты
Have a good time! - хорошо провести время!
Have a nice day! - приятного дня!
I'm working for an American company - я работаю для американской компании
How old are you? - сколько лет тебе?
What is your profession? - какая твоя профессия?
Where do you work? - где ты работаешь?
What are you doing? – чем вы занимаетесь?
What do you do professionally? - чем вы занимаетесь (профессионально)?
What do you do in life anyway? - чем вы занимаетесь по жизни?
What do you do for a living? – как вы зарабатываете на жизнь?
How do you earn a living? – как вы зарабатываете на жизнь?
What do you do in your free time? - что вы делаете в своё свободное время?
What do you do in your spare time? - что вы делаете в своё свободное время?
What do you do for fun? - как ты отдыхаешь?
Are you happy with your job? - ты счастлив на своей работе?
Flatten – становиться ровным; выравниваться; успокаиваться
Do you have a family? - у тебя есть семья?
Have you got a family? - у тебя есть семья?
What does she do? – чем она занимается?
At the moment I'm looking for a job - в данный момент я ищу работу
I graduated fifteen years ago with a master's degree in radio electronics - я закончил образование 15 лет назад со степенью магистра в радиоэлектронике
I graduated from the KNURE fifteen years ago - я закончил ХНУРЭ 15 лет назад
I have a degree in radio electronics - я имею степень в радиоэлектронике
Do you have a degree in marketing? - у тебя есть степень в маркетинге?
Do you ever go to Europe? – вы иногда ездите в Европу?
Every once in a while – время от времени
I go back every once in a while - я возвращаюсь время от времени
Spare – запасной; лишний; свободный
For now my career is my priority - сейчас карьера является моим приоритетом
Are you busy with work? – вы очень заняты на работе?
I'm in love with going to the gym – я обожаю заниматься в спортзале
work out – складываться; решать (задачу); отработать (долг); сработать; тренироваться
The plan works out – план срабатывает
Is your job demanding? – твоя работа ответственная?
When I was younger, I used to play football - когда я был моложе, я играл в футбол
I was born and raised in Kharkov - я родился и вырос в Харькове
I divorced my wife six years ago - я развёлся с моей женой 6 лет назад
Entrepreneur – бизнесмен; предприниматель
I'm a web designer - я веб дизайнер
I'm an IT specialist - я IT специалист
What does your company do? - что делает твоя компания?
I run my own business - я веду мой собственный бизнес
It's pretty good - это довольно хорошо
I'm an assistant professor - я доцент
I teach digital processing at the university - я преподаю цифровую обработку в университете
How long have you been doing that? - как долго ты занимаешься этим?
How long have you been in this business? - как долго ты в этом бизнесе?
Since I graduated - с тех пор как я закончил учёбу
I've been in this business for over ten years - я в этом бизнесе уже более 10 лет
I have been working here for only a week - я работаю здесь только неделю
What do you do at your job? - что ты делаешь на своей работе?
Do you like your job? - тебе нравится твоя работа?
I like it because I'm my own boss - мне нравится она потому что я свой собственный босс
Commitment – обязательство
Do you make good money? - ты зарабатываешь хорошие деньги?
Well, it depends on the deal - ну, это зависит от сделки
What's your professional background? - каков твой профессиональный опыт?
I'm out of work at the moment - я не работаю в данный момент
I lost my job - я потерял свою работу
I left my job - я покинул свою работу
I quit my job - я ушёл с работы
I didn't get a raise at work, so I had to quit - я не получил повышение на работе, поэтому я должен был уйти
I was fired - я был уволен
My position became redundant due to the financial crisis - моя позиция стала излишней вследствие финансового кризиса
What company are you working for? - для какой компании ты работаешь?
What kind of job are you looking for? - какой вид работы ты ищешь?
Go broke – разориться; обанкротиться
It went broke – она (компания) разорилась
I didn't get along with my boss – я не ладил с моим боссом
Waiter – официант
I usually have classes during the day – обычно у меня занятия днём
Environment – окружение; окружающая среда
Miracle – чудо
stipulation – условие; оговорка; соглашение
tradeoff – компромисс
retrofit – модифицировать
accommodate – подгонять; приспосабливать
anonymous – анонимный
What kind of education do you have? - какое образование у тебя?
What education do you have? - какое образование у тебя?
Did you go to college? - ты ходил в колледж?
What did you study? - что ты изучал?
Where did you study? - где ты учился?
I took two years of college and then dropped out - я провёл 2 года в колледже и затем бросил его
I went for two years and then I dropped out - я ходил в течение двух лет, а затем я бросил
What was your major at the university? - какая была твоя специализация в университете?
What's your major? - какая твоя специализация?
Do you work in the field that you majored in? - ты работаешь в области по своей специализации?
What field are you working in? - в какой области ты работаешь?
What do you want to achieve in your career? - чего ты хочешь достичь в своей карьере?
Do you have any career ambitions? - у тебя есть какие-нибудь карьерные амбиции?
To be a java developer would be perfect - быть Java разработчиком было бы идеально
I sent out letters everywhere – я разослал резюме повсюду
At the moment I'm considering a few job offers - в данный момент я рассматриваю несколько предложений работы
If I make enough money, I'll do it next year - если я заработаю достаточно денег, то я сделаю это в следующем году
Take out a loan – взять кредит
Revoke – отменять; аннулировать
Assurance – гарантия; заверение; уверенность
Insurance – страхование
I plan on starting my own business - я планирую начать свой собственный бизнес
I want to start as a Java developer - я хочу начать как Java разработчик
I plan on getting a master's degree in programming - я планирую получить магистерскую степень в программировании
I'm not making a lot of money right now, but I have good career opportunities - я не зарабатываю много денег прямо сейчас, но я имею хорошие карьерные возможности
I'm not making a lot of money right now, but I have a good perspective in this company - я не зарабатываю много денег прямо сейчас, но я имею хорошую перспективу в этой компании
My family could not pay for my education any more - моя семья не могла больше платить за моё обучение
Suppress – подавлять; пресекать; сдерживать; запрещать; скрывать
Ownership – собственность; владение; имущество
Win – победа; победить; выиграть
Sorry, I don't quite understand you - извини, я не совсем понимаю тебя
Haven't you met yet? - вы ещё не встречались?
Your friend is standing over there - твой друг стоит там
I live over there - я живу там
Glad to meet you - рад встретить тебя
Nice to meet you - приятно встретить тебя
Let me introduce my colleague - позвольте мне представить моего коллегу
I would like to improve my english - я бы хотел улучшить мой английский
I wanted to improve my knowledge and skills - я хотел улучшить мои знания и скилы
You will speak english fluently - ты будешь говорить на английском свободно
I attended english courses - я посещал курсы английского
For how long? - как долго?
I understand almost everything, but speak badly - я понимаю почти всё, но говорю плохо
I was invited for an interview - я был приглашён для интервью
What do you think about the company? - что ты думаешь о компании?
I think it is a very interesting and profitable business - я думаю это очень интересный и прибыльный бизнес
It corresponds to my profession and work experience - она соответствует моей профессии и опыту работы
I like the job you have offered me - мне нравится работа, которую ты предлагаешь мне
I accept your offer - я принимаю твоё предложение
I'm tired of it - я устал от этого
I will get there by car - я буду добираться туда на машине
How long have you been living here? - как долго ты живёшь здесь?
Are you satisfied with your job? - ты удовлетворён своей работой?
It's hard to say – сложно сказать
Do you think so? – ты считаешь так?
My friend is very proud of it - мой друг очень гордится этим
That is a little bit expensive - это немного дороговато
I would like to see it - я бы хотел увидеть её
May I come and see it now? - могу я прийти и увидеть её (квартиру) сейчас?
I'll be waiting for you - я буду ждать тебя
I think we can afford it - я думаю мы можем позволить себе это
Apply - применять; заниматься; обращаться с просьбой (заявлением)
I'd like to invite you to apply to my job - я бы хотел пригласить вас заняться моей работой
Please review the job post and apply if you're available - пожалуйста рассмотрите пост о работе и обращайтесь, если вы доступны
We are currently looking for a Java developer - мы в настоящее время ищем Java разработчика
At least six years of experience - по крайней мере 6 лет опыта
Curious – любопытный; любознательный; пытливый
Affinity – сходство; близость; влечение; тяготение
Thirst – жажда
Reply to questions – отвечать на вопросы
Troubleshoot – искать неприятности
Troubleshoot problems with our software - искать проблемы с нашим софтом
Relevant professional experience – значимый профессиональный опыт
Self-motivated and comfortable working independently - который сам себя мотивирует и которому комфортно работать независимо
Headset – головной телефон
This job requires – эта работа требует
Deploy – развёртывание; использовать; употреблять; развёртывать
Java developer should have experience - Java разработчику следует иметь опыт
Empathy – эмпатия; сочуствие; сопереживание
Deal – сделка; договор; соглашение; вести дела; иметь дело
Adherence – приверженность; верность; строгое соблюдение
Driven – гонимый; приводимый в движение; управляемый
Approach – подход (к решению задачи); приближение
Respectable – респектабельный; представительный; достаточный
Profile – профиль; профилировать; обрабатывать по шаблону
Profiling – профилирование; определение профиля
Seduction – соблазн; искушение; обольщение
Seduce – соблазнять; совращать
Temptation – искушение; соблазн
Payback – окупаемость; расплата
Bid – предложение цены; заявка (на торгах)
Replicate – отвечать; повторять; копировать; имитировать
Entire – полный; совершенный; чистый; целый
Seamless – бесшовный; плавный
Remain – остатки; оставаться; пребывать
Staff – палка; посох; штат; штаб
Dangling – висящий; волочащийся; бездельничающий
Multicasting – групповое вещание; групповая адресация
Broadcast – радиовещание; широковещательная рассылка
Mere – простой; всего лишь
Regard – внимание; рассмотрение; отношение; касательство; связь
Regarding – относительно; касательно
Regarding your proposal – что касается вашего предложения
Lack – недостаток; отсутствие; не хватать; недоставать
Confusion – смущение; замешательство; путаница; неразбериха
Obsolete – устарелый; старомодный
Receipt – квитанция; рецепт
Remaining – остальной; остающийся
Exploit – деяние; подвиг
To exploit – использовать; эксплуатировать; разрабатывать
Encourage – поддерживать; поощрять
Cruel – жестокий; беспощадный
Appreciate – ценить; быть признательным; принимать во внимание
Furious – взбешённый; неистовый; яростный
Anger – гнев; раздражение
Betrayal – измена; предательство
Cognition – познание; познавательная способность
Perception – восприятие; ощущение; осознание
Could you, please, repeat it slowly? – не могли бы вы, пожалуйста, повторить это медленнее?
The thing is – дело в том, что
Interesting thing is – вот что интересно, так это
Let it go! – отпусти это!; позволь этому случиться!
Let it happen! – пусть это случится!
Forgive me – прости меня
Forget about it – забудь об этом
Clever – остроумный; сообразительный; хитрый
I'm stuck in a rut – я застрял в рутине
I'd like some more coffee – я бы хотел ещё немного кофе
Let's find some more money – давай найдём ещё немного денег
We are having fun – мы веселимся; мы получаем удовольствие
All or nothing at all – всё или ничего вообще
At all – полностью; вообще
And you are? – А ты?
Afraid – испуганный; боящийся
To make afraid – пугать
I'm afraid – я боюсь (не решаюсь)
How can I help you? – как могу я помочь тебе?
I don't need any help – мне не нужна никакая помощь
I can handle everything on my own – я могу справиться со всем сам
I have nothing to say – мне нечего сказать
Best of luck here! – удачи!
You can get in touch with me by e-mail – вы можете связаться со мной по e-mail
You can get in touch with me on Skype – вы можете связаться со мной по Skype
How do you feel? – как ты себя чувствуешь? (эмоционально)
How are you feeling? – как ты себя чувствуешь? (физически)
I gotta go – мне нужно идти
I got to go – мне нужно идти
I will be able to do it – я смогу сделать это
I'm angry with you – я сердитый на тебя
Guess – догадка; предположение; гадать; полагать; считать
What have you been doing? – что ты такое делал (до настоящего времени), чем занимался? (что так выглядишь)
Let me think – дайте-ка мне подумать
I can do it – я могу сделать это
I must do it – я должен сделать это
I have to do it – я вынужден делать это; мне приходится делать это
You should write a perfect resume – тебе следует написать идеальное резюме
I may do it tomorrow – я возможно сделаю это завтра
I might do it today, but I won't – я мог бы это сделать сегодня, но не буду
I could do it – я мог бы это сделать (практически это реально)
Can you do it? – можешь ты сделать это?
Will you do it for me? – сделаешь это для меня?
Could you do it? – не могли бы вы сделать это?
Would you do it? – мог бы ты сделать это?
May I do it? – могу я сделать это? (спрашиваю разрешения)
Can I do it? – могу я сделать это? (есть ли такая возможность)
Should I do it? – следует мне сделать это?
I may wanna try it – возможно я захочу попробовать это
I could help you if you like – я мог бы помочь тебе, если ты хочешь
What would you like? – что бы ты хотел?
Where would you like to go? – куда бы ты хотел пойти?
I wouldn't do it – я бы не сделал этого
I would never do it – я бы никогда не сделал этого
I need to work – мне надо работать
Are you able to do it? – ты в состоянии сделать это?
Do you have to do it? – тебе обязательно делать это?
You don't have to go there, do you? – тебе ведь не обязательно идти туда, не так ли?
Notice – извещение; сообщение; уведомление; замечать; отмечать
If you want, you will do it – если ты хочешь, ты сделаешь это
This issue is worth discussing – этот вопрос стоит обсуждения
Erroneous – неверный; ошибочный
Enjoy – наслаждаться; получать удовольствие
I enjoy programming on Java – я наслаждаюсь программированием на Java
Don't jump to conclusions – не прыгай к выводам; не спеши с выводами
Danger – опасность
Objection – возражение; протест
Soldier – солдат
Chess – шахматы
Ditch – яма; прогуливать
Choose – выбирать
Between – между двумя
Among – среди многих
Wrong – ошибка; неправильность; неверный; ошибочный; сломанный
It's all going wrong – всё идёт неправильно (процесс)
Anxious – взволнованный; озабоченный; беспокоящийся
I'm anxious about it – я обеспокоен этим
What do you like to do most of all? – что тебе нравится делать больше всего?
Most of all I like creating new things – больше всего мне нравится создание новых вещей
I have something to do – мне нужно кое-что сделать
Are you at home? – ты дома?
Mad – сумасшедший; безумный; рассерженный
Why are you mad at me? – почему ты рассержен на меня?
Thank you for being here – спасибо тебе за пребывание здесь
Yield – плоды; урожай; прибыль; доход
What can this deal yield? – что может эта сделка принести? (какой доход)
Argue – спорить
I don't wanna argue with you – я не хочу спорить с тобой
Few – мало (исчисляемое)
A few – немного (но достаточно) (исчисляемое)
Little – мало (неисчисляемое)
It includes several issues – это включает несколько вопросов
I've gone through it – я проходил через это
I believe in you – я верю в тебя
I believe you – я верю тебе
Abroad – заграница
Would you like to share your secret with me? – ты бы не хотел поделиться своим секретом со мной?
What's the matter? – что случилось?; в чём проблема?
Does it matter? – имеет ли это значение?
Have you lost smth? – ты потерял что-то?
I'm good at programming – я хорош в программировании
I was going to say that! – я (как раз) собирался это сказать!
I wonder if you want to do it – мне интересно, хочешь ли ты делать это
It's a good idea to do it – это хорошая идея – делать это
My time is up – моё время вышло
Have you ever been abroad? – вы когда-нибудь были за границей?
No, I've never been abroad, but I'm going to – нет, я никогда не был за границей, но я собираюсь туда
Why don't you do it? – почему бы тебе не сделать это?
Why don't you go there? – почему бы тебе не пойти туда?
I like this task though – хотя мне нравится это задание
Stupid – глупый; тупой
Foolish – глупый; безрассудный
This is a promising project – это многообещающий проект
That's what I'm talking about – вот то, о чём я говорю
That's what I mean – вот что я имею в виду
That's why I do it – вот почему я делаю это
Apart – отдельно; на части
Laugh – смех; смеяться
Calm – тишина; покой; спокойный; успокаивать
Let's calm down! – давайте успокоимся!
Enough is enough – хорошего понемногу
Poor – бедный; несчастный
Fair – честный
Repair – ремонт; ремонтировать; исправлять
Care – забота; заботиться
I don't care – мне всё равно
Why do you care? – тебе то что?; почему тебя заботит?
Prepare – готовиться; подготавливаться
I need to prepare for my exam – мне нужно подготовиться к моему экзамену
Square deal – прозрачная (честная) сделка
Tear – слеза [tia]; рвать [tea]
What exactly did you do? – что именно ты делал?
I decided to do it – я решил сделать это
I called to ask smth – я звонил, чтобы спросить что-то
He said that to amuse you – он сказал это, чтобы позабавить тебя
I did it so you create high quality application – я сделал это так чтобы ты создала высококачественное приложение
I want you to be happy – я хочу, чтобы ты была счастлива
Do you want me to be happy? – ты хочешь, чтобы я был счастлив?
I want that to happen – я хочу, чтобы это случилось
I want him to talk with you – я хочу, чтобы он поговорил с тобой
I waited for him to come – я ожидал, что он придёт
I want this job to be done – я хочу, чтобы эта работа была сделана
I think it's high time for you to get a life – я думаю это самое время для тебя заняться своей жизнью
Just in time! – как раз вовремя!
I'm sure I'll be better this time – я уверен я буду лучше в этот раз
Come over here! – иди сюда!
So does he – как и он
Happen – случаться; происходить
Get them to do it – сделай так, чтобы они сделали это
Don't let him live off you – не позволяй ему жить за твой счёт
I'm not in the mood – я не в настроении
Let me be! – оставь меня в покое!
Leave me alone – оставь меня одного
I like having my english lessons – мне нравится заниматься моими английскими уроками
Throw – бросать; устраивать
Catch – улов; добыча; уловка; ловить; поймать; улавливать
Fall – падать; осень
He put it like that – он изложил это подобным образом
Get tired – устать (стать уставшим)
Get hungry – проголодаться (стать голодным)
Get ill – заболеть (стать больным)
Get angry – рассердиться (стать сердитым)
Put up with it! – смирись с этим!
I'm looking forward to hearing from you – я с нетерпением жду ответа от вас
I'm too busy to talk to you right now – я слишком занят, чтобы разговаривать с тобой прямо сейчас
I'm too smart to make such mistakes – я слишком умный, чтобы делать такие ошибки
I wish you were here – я бы хотел, чтобы ты был здесь
I wish I had smth – я бы хотел, чтобы я имел что-то
To study – учиться самому (быть в процессе обучения)
To learn – изучать
To teach – обучать кого-то
You have done it all wrong – ты сделал это всё неправильно (результат)
Now, what do we have here? – итак, что мы имеем здесь?
Do you like programming on Java? – тебе нравится программирование на Java?
She watched me doing it – она видела меня делающим это
I hate being ignored – я ненавижу быть игнорируемым
Permit – позволение; разрешение; позволять; давать возможность; разрешать
Enchant – очаровывать; восхищать
HR (human resources) – эйчар; отдел кадров
Admit – допускать; соглашаться; сознаваться
Reward – награда; премия; вознаграждение
Award – присуждение (награды, премии); награждать
Customer – заказчик; клиент
Employer – наниматель; работодатель
Employee – служащий; наёмный работник
He isn't anywhere – его нет нигде
This work is very hard to do – эту работу очень сложно сделать
Courage – бесстрашие; храбрость; отвага
Seek – искать; разыскивать
Totally, it's exactly what I wanted – полностью, это именно то что я хотел
So that – так чтобы
Help her do it – помоги ей сделать это
Have him sign it – попроси (вынуди) его подписать это
I like being here with you – мне нравится быть здесь с тобой
She must be very happy – она должно быть очень счастлива
Conform – согласоваться; соответствовать; приспосабливаться
What exactly is he doing? – что именно он делает? (процесс)
Disturb – мешать; тревожить; беспокоить
I have a lot of work to do today – у меня много работы, чтобы сделать сегодня
Can I watch you do it? – могу я посмотреть как ты делаешь это?
I love to watch them work – я люблю смотреть как они работают
We can do it later – мы можем сделать это позже
Touch – прикосновение; касание; касаться; трогать
Either – любой (из двух); тоже (с отрицанием)
Mean – иметь в виду; значить; подразумевать; предназначать
We were meant to meet – нам было предназначено встретиться
He is supposed to come – предполагалось, что он придёт
What is it? – в чём дело?
Mend – починка; чинить; ремонтировать
Fix – устанавливать; налаживать; ремонтировать; подправить
But I'm not very good with these things – но я не очень хорош с этими штуковинами
Hurray – урра
I'm an expert at these things – я эксперт в этих вещах
I don't know where the password is – я не знаю где пароль
I don't know why he did it – я не знаю почему он сделал это
Now, it's my turn – теперь моя очередь
What is going on? – что происходит?
Keep up – продолжать; содержать
Geek – чокнутый; помешанный
Until – до; пока; до тех пор
Maybe you can do it by yourself? – может быть ты сможешь сделать это сам?
He is like – и он такой говорит: «прямая речь»
He was like – и он такой сказал: «прямая речь»
He said I might use his code – он сказал, что я могу использовать его код
I thought you might like it – я думал, что тебе может понравиться это
He told us he would come – он сказал нам, что он придёт
I thought you would do it – я думал, что ты бы сделал это
Does she know where you are going? – она знает, куда ты собираешься?
We had been married for four years – мы были женаты в течении 4 лет
The contract has been signed – контракт был подписан
What am I supposed to say to my customer? – и что я теперь должен сказать моему заказчику?
Will I see you again? – я увижу тебя снова?
You're very likely to – скорее всего (ты есть очень вероятно к этому)
If I may ask – если мне можно спросить; если не секрет
Make into – превратить в
Don't worry! – не переживай!
That's it! – вот так!
Easy as pie! – проще простого!
a bit – немного; чуть-чуть
That's because – это потому-что …
Talking of – кстати, говоря о …
Speaking of – кстати, говоря о …
Splendid – роскошный; выдающийся; знаменитый; великолепный
Nearly – близко; почти
Listen to smth! – послушайте что-то!
What does it mean? – что это значит?
Neither do I – как и я (с отрицанием)
Never mind! – не берите в голову!
Maybe this wasn't such a good idea after all – может быть это была не такая уж хорошая идея в конце концов
What a beautiful girl! – какая красивая девушка!
I would prefer to work by myself – я бы предпочёл работать сам
What would you rather do? – что бы ты предпочёл сделать?
What would you prefer to do? – что бы ты предпочёл сделать?
I'd sooner do smth – я бы скорее сделал что-то
It's too difficult for you to understand – это слишком трудно для тебя, чтобы понять
Is it hard for you to understand? – это сложно для тебя, чтобы понять?
It's very important for me to manage my time – это очень важно для меня, управлять моим временем
It's necessary for it to be done – необходимо, чтобы это было сделано
Necessary – необходимое; необходимый; нужный; требуемый
Deliver – доставлять; освобождать; избавлять
Delivery – поставка; доставка
Delivered – доставленный
It's hard for me to say if he is right – это сложно для меня, сказать, прав ли он
To pass that exam – сдать тот экзамен
Vital – жизненно необходимый; полный жизни
Relative – родственник; относительный; сравнительный
Thoroughly – тщательно; основательно; полностью; совершенно
Is it ok for you if I come at seven? – это нормально для тебя, если я приду в 7?
I'm dying for you to tell me! – я прям умираю для тебя, чтобы ты рассказал мне!
It's for you to decide! – тебе решать!
Blame – виновность; порицание; осуждение; осуждать; обвинять
It's not for you to blame me! – не тебе меня судить!
Reason – разум; ум; здравомыслие; повод; причина; рассуждать; доказывать
Attend to your business – занимайтесь своим делом
It wouldn't hurt for you to do that – это бы не повредило тебе сделать такое
Shall I do it for you? – должен ли я сделать это для тебя?
You will have to be patient – тебе придётся быть терпеливым
I won't have to do it – мне не придётся делать это
I'm gonna have to do it – мне скорее всего придётся сделать это
Pure – чистый; беспримесный; безупречный
He never did it – он так и не сделал этого
To match – подходить; соответствовать
We always get together – мы всегда собираемся вместе
He is always right – он всегда прав
I won't tell anyone – я не скажу никому
Nobody will know – никто не узнает
Isn't it a bad time for you? – вам удобно говорить? (ведь это не плохое время для вас?)
Interrupt – мешать; прерывать
Especially – особенно; главным образом
Get the sense – уловить суть
Are you done? – ты закончил?
Is it done? – это сделано?
Isn't it done? – разве это не сделано?
Why isn't it done? – почему это не сделано?
Weren't you invited? – разве ты не приглашён?
Will it be done tomorrow? – будет ли это сделано завтра?
I'm gonna be told – скорее всего мне расскажут
Is it gonna be done soon? – будет ли это сделано вскоре?
This book is being written – эта книга сейчас пишется
It's being discussed – это сейчас обсуждается
Explain – объяснять
This work must be finished as soon as possible – эта работа должна быть закончена так скоро, как возможно
Sell – продавать
Invent – изобретать; создавать; выдумывать
Behaviour – манеры; поведение
I wish I didn't have smth – я бы хотел, чтобы я не имел чего-то
You're really very good at it – ты реально очень хорош в этом
A third is not given! – третьего не дано!
Well begun is half done! – хорошо начатое – наполовину сделанное!
It was done with his permission – это было сделано с его разрешения
I'm very much taken with this idea – я очень сильно увлечён этой идеей
The only thing – единственное
My work is the only thing I can think about – моя работа это единственное, о чём я могу думать
Explore – исследовать; выяснять; анализировать; экспериментировать
Exploration – исследование; изучение
Discover – обнаруживать; узнавать; делать открытие
Appearance – появление; выступление; видимость; наружность; внешний вид
Deceive – обманывать; вводить в заблуждение
Appearances can be deceiving – внешность может быть обманчивой
Punish – наказывать
Will you be quiet, please? – можешь быть тише, пожалуйста?
Rules are made to be broken – правила сделаны, чтобы быть нарушенными
It's good to be here! – хорошо быть здесь!
How long will it take? – как долго это займёт?
It will take all day – это займёт весь день
I'm not gonna have to explain anything – мне скорее всего не придётся объяснять ничего
Perhaps – возможно; наверно
He could have done it himself, but he didn't – он мог бы сделать это сам (тогда), но не сделал
She couldn't have said that! – не могла она сказать такого!
She must have been about twenty then – ей, должно быть, было лет 20 тогда
He must have failed to get that job – ему, должно быть, не удалось получить ту работу
It has to be ready by the end of the week – это должно быть готово к концу недели
You won't get paid – ты не получишь оплату
Forget – забывать
We shouldn't have disputed – нам не следовало спорить
Dispute – диспут; дебаты; дискуссия; спорить
If I were clever, I would be rich – если бы я был умным, я был бы богатым
Everything is in its place – всё на своём месте
Today was made for me – этот день был сделан для меня
It's getting cold – становится холодно
That is the best film I have ever seen – это лучший фильм, который я когда-либо видел
It must have been fun – это должно быть было весело
Funny – забавно; смешно
Something like that – что-то типа того
Take care! – береги себя!
Savage – дикий; жестокий; взбешённый; невоспитанный
Please – пожалуйста; радовать; доставлять удовольствие
Pleasure – удовольствие
Pleasant – приятный
Pleased – довольный
Here you are – вот, пожалуйста
You're welcome – пожалуйста
It was nothing – не о чем говорить; не за что
Don't mention it – не упоминай это (не стоит благодарности)
Sorrow – печаль; горе; сожаление
Sorrowful – печальный; плачевный; несчастный
To be sorry – сожалеть
I'm sorry to say he is stupid – к сожалению, должен сказать, что он тупой
I beg your pardon! – умоляю, извините!
I'm terribly sorry – я ужасно огорчён
I offer my most sincere apologies – приношу мои самые искренние извинения
How are things? – как дела?
How is everything? – как дела?
How is it going? – как дела?
How have you been? – как поживаете?
Couldn't be better! – не могло быть лучше!
Could be worse – могло быть хуже
So so – так себе
Just great! – прямо отлично!
Getting by – понемножку
Same as always – так как всегда
Not so well – не так хорошо
Kind of lousy – довольно паршиво
Lousy – вшивый; паршивый; отвратительный
Well done! – отлично сделано!
Go ahead! – пожалуйста!; вперёд, начинай!
Don't even think about it! – даже не думай об этом!
Cause – причина; основание; вопрос; послужить причиной/поводом
I don't like bothering people – я не люблю напрягать (надоедать) людей
Fix the problems – решать проблемы
Anyway – во всяком случае; так или иначе
I haven't done it yet – я не сделал этого ещё (результат)
Lately – недавно; в последнее время
Whom are you talking? – с кем ты разговариваешь?
Who are you talking to? – с кем ты разговариваешь?
Where are you going to? – куда ты едешь?
In how many days will it be done? – через сколько дней это будет сделано?
He is well-off – он хорошо зарабатывает
For whose sake are you doing all this? – ради кого ты делаешь всё это? (процесс)
There were seven candidates for the position – на это место было 7 кандидатов
There is an error there – там есть ошибка
There is no answer to this question – нет ответа на этот вопрос
There is no solution to this problem – нет решения у этой проблемы
Are there any questions? – есть какие-нибудь вопросы?
I have one question – у меня один вопрос
Your proposal has many drawbacks – ваше предложение имеет много недостатков
There is a significant drawback in your proposal – есть значительный недостаток в вашем предложении
There were many people who made the same mistake that I did – было много людей, которые сделали ту же ошибку, что и я
You know, there's a problem – вы знаете, есть одна проблема
It is difficult to be a boss – трудно быть начальником
It isn't easy to answer this question – нелегко ответить на этот вопрос
It's hard to understand what she is talking about – трудно понять, о чём она говорит
Way – путь; дорога; расстояние; сторона; направление; отношение; образ; манера; способ
We lost our way – мы сбились с пути
I can see no way out for us – я не могу увидеть выход для нас
He has come a long way in his work – он далеко продвинулся в своей работе
Which way are you going? – в какую вам сторону?
In a way, you are right – в некотором отношении вы правы
This was wrong in every way – это было неправильно во всех отношениях
No way! – ни за что!; так не пойдёт!
There is no other way to do it – нет другого способа сделать это
In what way can I get this information? – каким образом я могу раздобыть эту информацию?
This is the way to do it! – это способ, чтобы сделать это!
Do it any way you like – делайте это любым способом как вам нравится
Have it your way – пусть будет по вашему
That's the way it works! – вот как это работает!
That's the way it goes – вот так уж повелось
Just the other way around! – как раз наоборот!
To have a way with – уметь обращаться с
In order to – для того, чтобы
To start press the button – чтобы начать, нажмите кнопку
To get a better job, you need more time – чтобы получить работу получше, тебе нужно больше времени
Newcomer – вновь прибывший; новичёк
Co-worker – сослуживец
Barely – только; едва
Unknown – неизвестный
Unhappy – несчастливый
Incorrect – неверный
Incredible – невероятный
Inevitable – неизбежный
Impossible – невозможный
To dislike – не любить
You misunderstood me – вы неправильно меня поняли
It's just a misunderstanding – это просто недоразумение
Workable – осуществимый; годный для обработки
Unreliable – ненадёжный
Unacceptable – неприемлемый
I'm having a business – я занят делом
I just thought – я просто подумал…
You know, I've been thinking about it – ты знаешь, я тут подумал об этом…
What are you thinking about? – о чём ты думаешь?
I've seen this many times before – я видел это много раз прежде
I'm seeing my customer tomorrow – я встречаюсь с моим клиентом завтра
He's always doing this – он всегда делает это (сказано с раздражением)
I can see – могу представить…
Just keep it real – просто оставь как есть
When it's official, we'll talk again – когда это будет подтверждено, мы поговорим снова
It's gonna have to be done – это скорее всего придётся сделать
Cost – цена; стоимость; стоить; назначать цену
To be in pain – испытывать боль
Hurt – вред; травма; повреждение; болеть; повредить
I didn't want to hurt you – я не хотел причинить тебе боль
Treat – обращаться; трактовать; рассматривать; обсуждать; лечить
To heal – излечивать (раны)
Cure – лечение; лекарство; излечивать (болезнь)
You can learn both Java and Python – ты можешь изучать как Java, так и Python
Either or – или …, или
Neither nor – ни …, ни
He is either sick or drunk – он или болен, или пьян
Either come in or go out – или входите, или выходите
She speaks neither German nor French – она не говорит ни по-немецки, ни по-французски
I don't like ice-cream either – я не люблю мороженое тоже
Either of them can do it – любой из них может сделать это
I don't know the answer, and neither does he – я не знаю ответа, и он тоже не знает
I don't know the answer, and he doesn't, either – я не знаю ответа, и он не знает тоже
Still – ещё; всё ещё; однако; всё же; тем не менее
He is still busy – он ещё занят
I'm still waiting for your reply – я всё ещё жду вашего ответа (процесс)
I have already done it – я уже сделал это (результат)
Have you done it already? – ты сделал это уже? (результат)
I've already told him about it – я уже рассказал ему об этом (результат)
He is already here – он уже здесь
Yet – ещё не; уже; однако; всё же; тем не менее
He is not here yet – он ещё не здесь
Are you ready? – вы готовы?
Not yet – ещё нет
Are you ready yet? – вы уже готовы?
Aren't you ready yet? – вы ещё не готовы?
One more – ещё один
Some more – ещё немного
Once more – ещё раз
One more time – ещё раз
No more – больше не
Any more – больше не
What else do you want? – чего ещё ты хочешь?
Where else can we go? – куда ещё мы можем пойти?
Ask someone else – спроси кого-нибудь другого
Nobody else understands me – никто другой не понимает меня
Would you like to drink anything else? – ты бы хотела выпить чего-нибудь ещё?
Let's go somewhere else – давайте пойдём куда-нибудь ещё
I've been able to do it – я смог сделать это
Have you been able to do it? – ты смог сделать это?
He may be late – он возможно опаздает
I might do it, but I'm not sure for the quality – я мог бы сделать это, но я не уверен за качество
It's supposed to be so – предположительно это должно быть так
I've had to do it – мне пришлось сделать это (результат)
No one says like that – никто не говорит так
Could you call me later? – не могли бы вы позвонить мне позже?
to get – получать; раздобыть; достать; принести; поймать; понимать; добираться; становиться; начинаться
get to – сделать так, чтобы сделалось; заставить (уговорить, повлиять)
You got what you deserved – ты получил то, что заслужил
I never got your letter – я так и не получил ваше письмо
Where did you get this book? – где вы достали эту книгу?
He got me a job – он раздобыл мне работу
I'll get you this book – я достану вам эту книгу
What can I get you? – что могу я принести вам?
I didn't get the joke – я не понял этой шутки
You got me wrong – вы неправильно меня поняли
Do you get what I mean? – ты понимаешь, что я имею в виду?
Can I get there by train? – могу я добраться туда поездом?
Get going! – начинай двигаться!; пошёл!; марш!
It's time for us to get going – нам пора начинать двигаться
She'll get him to do this work – она заставит его сделать эту работу
Can you get your colleague to help us? – можете вы уговорить вашего коллегу помочь нам?
I got you! – я поймал тебя!
I gotcha! – я поймал тебя!
Get along – ладить
Get into – попасть в
He got into trouble – он попал в неприятную историю
He got her into trouble – он втянул её в неприятную историю
She got into debt – она влезла в долги
Get out – выбираться (откуда-либо)
Get out of here! – убирайся отсюда!
We gotta get out of here – нам надо выбираться отсюда
You're getting on my nerves – ты начинаешь действовать мне на нервы
He was seen with her – его видели с ней
Half-done work – наполовину сделанная работа
Well-known actor – хорошо известный актёр
The game was lost – игра была проиграна
Praise – похвала; хвалить
He was praised for his work – его похвалили за его работу
I'm so excited about it – я так взволнован этим
Your idea is interesting, but I'm not interested in this job – ваша идея интересна, но я не заинтересован в этой работе
Not at all – вообще нет
Are you interested in this proposal? – вы заинтересованы в этом предложении?
to speak – произносить слова; говорить
to say – говорить; сказать
to tell – говорить; рассказывать; сообщать (информацию)
talk – разговор; беседа; разговаривать; беседовать; общаться
talks – переговоры
I must say that you are wrong – я должен сказать, что вы неправы
He is, so to say, my assistant – он, так сказать, мой ассистент
You promised not to tell – ты обещал не рассказывать
I can tell you what she said – я могу рассказать тебе, что она сказала
Say what? – говорить что?
Tell whom? – сказать кому?
She said that – она сказала это
She said that to me – она сказала это мне
She told me about it – она рассказала мне об этом
What did she say? – что она сказала?
What did she tell you? – что она сказала тебе?
To tell the truth – говорить правду
To tell a lie – говорить неправду
I told you so! – я же говорил тебе так!
It's just talk! – это только разговоры!
Stop talking! – прекратите разговаривать!
What are you talking about? – о чём вы говорите?
be about to – скоро; вот-вот
The lesson is about to start – урок скоро начнётся
Don't worry, it's gonna be all right! – не переживай, всё будет в порядке!
You can join us if you will – вы можете присоединиться к нам, если желаете
She is willing to answer your questions – она охотно ответит на ваши вопросы
Purchase – покупка; приобретение; покупать; приобретать
If you don't mind – если вы не возражаете
How should I know? – откуда мне знать?
Why should I? – с  какой стати?
Homework – домашняя работа
Shout – возглас; крик; кричать
Shift – изменение; сдвиг; смена; изменять; переключать
Full-time employment – полная занятость
Part-time employment – частичная занятость
Temporary employment – временная работа
Self-employment – работа на себя
Job market – рынок труда
Job requirements – требования работы
Job opening – вакансия
Immediate opening – срочная вакансия
Entry level position – стартовая должность
Over-time – сверхурочные
Pay and benefits – зарплата и льготы/премии
Previous experience – предыдущий опыт
Head hunter – охотник за головами (рекрутер)
Job hunting – поиск работы
Detail oriented – ориентированный на детали
Applicant – кандидат; претендент
Objective – цель; целевой; объективный; реальный
Cover letter – сопроводительное письмо
Professional accomplishments – профессиональные достижения
Appropriate – подходящий; соответствующий; свойственный; присущий; присваивать; назначать; предназначать
Coverage – сфера действия; рамки; границы; масштаб; освещение в СМИ
Confidence – вера; доверие; уверенность; конфиденциальность
Strengths and weaknesses – сильные и слабые стороны
Polite – вежливый; любезный; изящный; изысканный
When will you make your decision? – когда вы примете ваше решение?
Chief – руководитель; лидер; начальник; шеф
Company headquaters – главный офис компании
Vacation – оставление; освобождение; отпуск; отдых
Vacation of a position – уход с должности; отставка
Probation period – испытательный срок
Yell – крик; кричать; выкрикивать
Competitive wages – конкурентная зарплата
I have in-depth experience in this field – у меня огромный опыт работы в этой области
Appointment – назначение; должность; свидание; встреча
Hold an appointment – занимать должность
She must be having an appointment now – она, должно быть, на встрече сейчас (процесс)
He must be thinking about her – он, должно быть, думает о ней (процесс)
She must've been doing smth – она, должно быть, делала что-то (долго)
He may not want to come – он, возможно, не захочет приходить
He may have done smth – он, возможно, сделал что-то (результат)
He may not have seen her – он, возможно, не видел её (результат)
I might as well – я мог бы так же
Without saying a word – не говоря ни слова
hear out – выслушать
You should've heard him out – тебе следовало выслушать его
You shouldn't have said it – тебе не надо было говорить это
You shouldn't have done it – тебе не следовало этого делать
Shouldn't you be doing your work? – разве ты не должен делать свою работу? (процесс)
It can't be true – это не может быть правдой
Can it be true? – неужели это правда?
Can they still be working? – неужели они всё ещё работают? (процесс)
Can he have forgiven her? – неужели он простил её? (результат)
He can't have forgiven her – не может быть, чтобы он простил её (результат)
Be allowed to – будет разрешено
They will be allowed to do it – им будет разрешено сделать это
Tight – сжатый; плотный; тугой; строгий; надёжный; трудный
Claim – заявление; утверждение; претензия; требование; заявлять; утверждать; требовать
Deny – отказывать; отрицать
Persuade – убеждать
I am here to help you – я здесь с целью помочь тебе
Were you able to cancel it? – ты был способен отменить это?
Fault – вина; проступок; промах; недостаток; объявлять ошибочным
Outrage – грубое нарушение; акт насилия; возмущение; гнев; оскорбление; совершать насилие; возмущать; оскорблять
Outrageous – жестокий; возмутительный; оскорбительный; скандальный
It goes without saying – само собой разумеется
I can't believe what I'm hearing – не могу поверить, что я выслушиваю
Neither – ни один (из двух), тоже не (с отрицанием)
Both and – как это, так и это
Either one is fine – любой из них (из двух) хорош
Mary likes music, and so do I – Мэри любит музыку, и я тоже
I like both of these pictures – мне нравятся оба эти изображения
Choice – выбор
Indeed – действительно; конечно; несомненно
Will you allow me to do it? – ты позволишь мне сделать это?
Be careful! – осторожно!
Retard – задержка; запаздывание; промедление; замедлять; тормозить; медлить; отставать
Trick – обман; хитрость; трюк; фокус; обманывать
Abuse – оскорбление; злоупотребление; избиение; изнасилование; оскорблять; бесчестить; злоупотреблять; избивать; совращать; насиловать
Forbid – запрещать
If I'm invited, I will come – если я приглашён, то я приду
If there's something interesting, I'll go there – если там будет что-то интересное, то я пойду туда
If there are some questions, I will answer – если будут какие-то вопросы, то я отвечу
If there were no jams, I would go there – если бы там не было пробок (сейчас), то я бы поехал туда (сейчас)
If I was invited, I came – если меня приглашали, то я приходил
If I had listened his recommendations, I could have done it better – если бы я выслушал его рекомендации (тогда), то я мог бы сделать это лучше (тогда)
If I had listened his advices, I would've been taken to that job – если бы я выслушал его советы (тогда), то я был бы взят на ту работу (тогда)
If I wanted, I would do it – если бы я хотел (сейчас), то я бы сделал это (сейчас)
If I had wanted, I would have done it – если бы я хотел (тогда), то я бы сделал это (тогда)
If I could help you, I would do it, but I can't – если бы я мог помочь тебе (сейчас), то я бы сделал это (сейчас), но я не могу (сейчас)
If I had been able to do it – если бы я смог сделать это (тогда), ...
If I would had to do it – если бы мне пришлось сделать это (тогда)
I would be able to do it – я бы смог сделать это
I would have to do it – мне бы пришлось сделать это
There would be more possibilities – было бы больше возможностей
There would be less problems – было бы меньше проблем
I would go crazy – я бы с ума сошёл
Without any thinking – не думая
If I were you, I would think about that – если бы я был на твоём месте, то я бы задумался об этом
I wish I were richer – я бы хотел быть богаче
I wish I had more money – я бы хотел иметь больше денег
I wish I had done it – хотел бы я, чтобы я сделал это (тогда)
I wish you would do it – как бы я хотел, чтобы ты сделал это
I wish she would forgive me – как бы я хотел, чтобы она простила меня
I hope it will happen – я надеюсь, что это случится
It's a pity that I don't understand you – как жаль, что я не понимаю вас
I wish you wouldn't interrupt me – я бы хотел, чтобы вы не мешали мне
You behave like nothing happened – ты ведёшь себя так, будто ничего не произошло
You'd better hurry – тебе бы лучше поторопиться
Addict – наркоман; заядлый любитель; увлекаться
Addicted – склонный; пристрастившийся
Addiction – склонность; вредная привычка
Grateful – благодарный; признательный
Destiny – рок; судьба; участь
Farewell – прощание; прощальный; добрый путь!
Fate – судьба; доля; фатум; предназначать
Being inspired you can do everything – будучи вдохновлённым ты можешь сделать всё
I like being respected – мне нравится, когда меня уважают
I like being listened – мне нравится, когда меня слушают
I don't like being cheated – мне не нравится, когда меня обманывают
I don't like being neglected – мне не нравится, когда мной пренебрегают
avoid – избегать
Cheat – жулик; обманщик; мошенник; мошенничество; мошенничать; обманывать; надувать; изменять
Regret – сожаление; огорчение; сожалеть
I regret doing it – я сожалею, что сделал это
I regret to say it – я сожалею, что говорю это
It's a good chance to do smth – это хороший шанс сделать что-то
It's a good chance of doing smth – это хороший шанс сделать что-то
He is considered to be a good specialist – он считается хорошим специалистом
He allowed me not to come – он разрешил мне не приходить
He ordered him to remake – он приказал ему переделать
Get away with it – уйти безнаказанным
He let her get away with it – он позволил ей уйти безнаказанной
He made her do it – он заставил её сделать это
Gratitude – благодарность; признательность
Fright – страх; испуг
Frighten – пугать
Frightened – испуганный
Envious – завистливый
I understand her doing it – я понимаю, почему она делает это
I understand her being upset – я понимаю, почему она ведёт себя расстроенной
I understand her being like that – я понимаю, почему она ведёт себя подобным образом
Commit – совершать; вверять; поручать; фиксировать
I'm sorry for interrupting you – прошу прощения, что перебил вас
He seems to want it – кажется, что он хочет этого
He seems to want to say smth to you – кажется, что он хочет сказать что-то тебе
He turns out to have a work – он, оказывается, имеет работу
He turned out to be married – он, оказалось, женат
He doesn't seem to have a soul – кажется, у него нет души
Appear – показываться; появляться; выходить; казаться
He appears to be tired – он кажется уставшим
He is known to be a good programmer – известно, что он хороший программист
He is known to live in Ukraine – известно, что он живёт в Украине
Certain – точный; определённый; уверенный; верный
He is certain to go by car – он точно поедет на машине
Certainly – конечно; несомненно
Certainly he will go by car – конечно он поедет на машине
Surely – конечно; несомненно; уверенно; верно
He is less likely to do it – ему сложнее сделать это
He is more likely to do it – ему проще сделать это
He said that he didn't like that – он сказал, что ему не нравится это
He said he had done it – он сказал, что он сделал это (результат в прош.)
He said that he was reading a book – он сказал, что он читает книгу
He asked if I liked it – он спросил, нравится ли мне это
He asked whether I liked it – он спросил, нравится ли мне это
Can't you get it? – неужели ты не можешь понять это?
Don't you like it? – разве тебе не нравится это?
He asked if I really didn't like it – он спросил, действительно ли мне не нравится это
Why don't you like it? – почему тебе не нравится это?
He asked me why I didn't like it – он спросил меня, почему мне не нравится это
He asked if that was possible to do it – он спросил, возможно ли сделать это
They asked if they could get it – они спросили, могут ли они получить это
Could that be true? – могло ли такое быть правдой?
Wherever – где бы ни; куда бы ни
no matter – неважно
no matter how – неважно как
no matter where – где бы то ни было; неважно куда; неважно где
no matter what – неважно что
it doesn't matter what – неважно что
it doesn't matter where – где бы то ни было; неважно куда; неважно где
I will do it whatever you'll tell me – я сделаю это, что бы ты ни говорил мне
No matter what people think I will do it – неважно что люди думают, я сделаю это
It doesn't matter what people think I will do it anyway – неважно что люди думают, я сделаю это, так или иначе
No matter how hard you do smth – неважно как упорно ты делаешь что-то
astonish – изумлять; поражать; удивлять
astonishing – изумительный; ошеломительный; удивительный
I don't care whether you believe it or not – мне всё равно, веришь ли ты этому или нет
I wanna know if this work is done – я хочу знать, сделана ли эта работа
I wanna know when it will happen – я хочу знать, когда это случится
I wanna know what time it will happen – я хочу знать, во сколько это случится
I wanna know on what day it will happen – я хочу знать, в какой день это случится
I wanna know why it happened – я хочу знать, почему это произошло
I wanna know why you need it – я хочу знать, зачем тебе это нужно
I wanna know because of what it happened – я хочу знать, из-за чего это произошло
I wanna know how much money you spent – я хочу знать, сколько денег ты потратил
I wanna know how long you have been living with him – я хочу знать, как долго ты живёшь с ним
I wanna know how many years you have worked for him – я хочу знать, сколько лет ты проработал на него
I wanna know how you are gonna do it – я хочу знать, как ты собираешься сделать это
I wanna know what in the world you want – я хочу знать, чего вообще ты хочешь
I wanna know for what you need it – я хочу знать, для чего тебе это нужно
I wanna know what you need it for – я хочу знать, для чего тебе это нужно
I wanna know which of these applications is yours – я хочу знать, какое из этих приложений твоё
I wanna know how serious your offer is – я хочу знать, насколько серъёзно ваше предложение
I wanna know how much you want it – я хочу знать, насколько сильно ты хочешь этого
Offer – предложение; предлагать
I wanna know for whom you do it – я хочу знать, для кого ты делаешь это
I wanna know who you do it for – я хочу знать, для кого ты делаешь это
There's smth you should know – есть кое-что, что тебе следует знать
There's nothing you have to do – нет ничего, что ты обязан делать
There's one thing I want to tell you – есть одна вещь, которую я хочу рассказать тебе
There are many ideas you may use – есть много идей, которые ты можешь использовать
There are so much to tell you – есть так много, чтобы рассказать тебе
I have smth interesting to show you – у меня есть кое-что интересное, что мне нужно показать тебе
The thing he is trying to say – то, что он пытается сказать (процесс)
I like the thing you're doing – мне нравится то, что ты делаешь (процесс)
I like the way you do it – мне нравится, как ты делаешь это (вообще)
I like the way he is doing his work – мне нравится, как он делает свою работу (процесс)
In a way to do smth – так, чтобы сделать что-то
In a way that does smth – таким образом, который сделает что-то
Do it in a way to earn some money – сделай это так, чтобы заработать немного денег
Do it in a way that brings money – сделай это таким образом, который принесёт деньги
That's the very film I told you about – вот тот самый фильм, о котором я тебе рассказывал
This film is the one I told you about – этот фильм тот самый, о котором я тебе рассказывал
The thing I like about her is the way she dresses – то, что мне нравится в ней, это как она одевается
What I like about her is the way she dresses – что мне нравится в ней, это как она одевается
It doesn't make you happier – это не делает тебя счастливее
It doesn't make it easier to do – это не делает это легче сделать
Masterly – мастерский; совершенный; мастерски
Completed – законченный; завершённый
Execute – осуществлять; выполнять; исполнять
Realized – выполненный; реализованный
Belong – подходить; соответствовать; сочетаться; принадлежать
Fraud – обман; мошенничество; подделка; обманщик; мошенник
Pretender – притворщик; претендент
It's important to make a good impression – важно произвести хорошее впечатление
Elevate – поднимать; повышать; продвигать; улучшать
Depress – понижать; ослаблять
Sentence – предложение; высказывание; приговор; осуждение
Altogether – вполне; полностью; всецело; совершенно
Bargain – соглашение; сделка; выгодная покупка; заключить сделку; торговаться
Advise – советовать; сообщать; уведомлять
He used to do it – он раньше (обычно) делал это; он имел привычку делать это
To learn it by heart – учить это наизусть
Endorse – подтверждать; одобрять; поддерживать
Endorsement – подтверждение; одобрение; поддержка
Customize – переделывать; подгонять
You behave as if you didn't know it – ты ведёшь себя так, как если бы ты не знал этого
You behaved as though you didn't know it – ты вёл себя так, как будто бы ты не знал этого
I would rather do smth – я бы лучше предпочёл сделать что-то
I'd rather not do it – я бы лучше предпочёл не делать этого
I'd rather you did it – я бы лучше предпочёл, чтобы ты сделал это
I'd better not do it – я бы лучше не делал этого
Terrific – страшный; ужасающий; прекрасный; отличный; потрясающий
Terrifically – страшно; ужасно; отлично; замечательно
Terrify – ужасать; внушать страх; запугивать
Terrible – страшный; ужасный; громадный
He feels like working – он в настроении поработать
He looks like going to leave – он выглядит собирающимся уйти
He is thought to be a diligent employee – он нём думают, что он усердный работник
Launch – запуск; запускать; начинать
Customizable – настраиваемый
first draft – первый (черновой) набросок
Cookie – печенье
Flavor – вкус
Stuff – имущество; вещи; хлам
take credit for – ставить себе в заслугу
kid – надувать; обманывать; шутить; дурачить
are you kidding? – ты шутишь?
Draw – рисунок; ничья; жребий; лотерея; тяга; вытягивание; приманка
To draw – рисовать; чертить; тянуть; притягивать; привлекать
Confess – признаваться; сознаваться
Miss – промах; потеря; отсутствие; упускать
Stand – стенд; стоянка; остановка; стоять
Reach – достичь; достигать
Pull – напряжение; усилие; тяга; натяжение; тянуть
Halt – остановка; остановить
Consonant – согласный; созвучный; совместимый
Trip – поездка; путешествие
Beat – удар; биение; бой; бить; побеждать
To climb – взбираться
Climbed – взобравшийся
Plural – множественный
Chart – график; диаграмма
Gear – передача
Fixate – зацикливаться
Tie – галстук; узел; связка; связать
This way – так; таким образом; сюда
I'll be there for you – я помогу тебе
I'll be there for you, cause you're there for me too – я помогу тебе, потому что ты помогаешь мне тоже
I'll be there for you, like I've been there before – я помогу тебе, как я помогал тебе раньше
Come on! – да брось!; вперёд!; давай!
Instead of – вместо
That's right! – именно!
All of a sudden – неожиданно
It turns out – оказывается
feel like – быть склонным; быть в настроении; хотеть
out loud – вслух
gorgeous – великолепный; шикарный
turned on – возбуждённый
it hit me – меня осенило
kind of – вроде как
that wouldn't be an issue – это бы не было проблемой
well, it matters to me – ну, это имеет значение для меня
survivor – выживший
it sucks – это отстой
you got screwed – тебя поимели
I'm all better – я чувствую себя лучше
This is for the best – это к лучшему
Be away – отлучиться
Hit on – заигрывать; приударять
Like there's a smth – как будто есть что-то
Horrible – ужасный; страшный; отвратительный
Be supposed to – быть должным (сделать что-либо)
Head for – направляться на
Hang out – зависать; тусоваться
Whatsoever – какой бы ни
How did you get through it? – как ты справился с этим?
Cut off - отрубать; отрезать; разъединять
That's like saying – это как говорить
Horny – сексуально озабоченный
Ever since – с тех пор
Revelation – откровение
Date – дата; свидание; назначать свидание; ходить на свидание
Perform – совершать; действовать; выполнять; исполнять
Smash – разбивать
Here is the thing – дело вот в чём
Get it together – взять себя в руки
Be on a roll – быть в ударе
Shut up – заткнись
Make a difference – менять (что-либо)
It doesn't make much of a difference – это ничего существенно не меняет
I doubt it – я сомневаюсь в этом
Get up – вставать
Wish me luck – пожелай мне удачи
Severe – тяжёлый; серъёзный; суровый; жестокий; жёсткий
Give me a break! – отстань от меня!
End up – оказаться; закончить; закончить тем, что
I don't think so – я не думаю так
Crash – авария; крушение; падать; валиться; разбиваться
Are you gonna be ok? – ты будешь в порядке?
Split – делить
To figure – полагать; считать; представлять себе
Figured – фигурный; образный
Ask smb out on a date – пригласить кого-то на свидание
Do you think it would be ok if? – ты думаешь это будет нормально, если?
Go out – выходить; ходить на свидание
Clarification – пояснение
Obligation – обязанность; обязательство
Subject matter – предмет изучения
Pass off – выдавать
Unravel – разгадывать; распутывать
Go away – уходить
Break up – расставаться; разрывать отношения; ломать; разбивать на части; делать перерыв
For good – навсегда
Credence – обоснование; доверие
What else? – что же ещё?
What are you gonna do with it? – что ты собираешься делать с этим?
Take advantage of – воспользоваться; пользоваться преимуществом
In the depths of despair – в глубинах отчаяния (в полном отчаянии)
Demand – потребность; спрос; требование; требовать
Turn into – превратить в
Of course not – конечно же нет
Not all that – не всё что
Judging by – судя по
Affection – влечение; привязанность
Violate – нарушать
Make out – разбирать; понимать; целоваться
Imply – предполагать; подразумевать
Implied – предполагаемый; подразумеваемый
Make point – донести точку зрения
Beyond repair – не подлежащий восстановлению
Far more – намного более
Compelling – убедительный
Move on – двигаться дальше
Go off – судить по; исходить из; уходить; уезжать
Disgusting – отвратительный
Until recently – до недавнего времени
Bring to mind – напоминать
Anyhow – так или иначе
a number of – некоторое количество
I'm really not familiar enough with – я действительно недостаточно знаком с 
Figure out – выяснять; разобраться
For a while – некоторое время
The point is – дело в том, что
In a good way – в хорошем смысле
Attempt – попытка
I don't get the point – я не понимаю смысла
Find out – узнавать; понимать; выяснять
It's common mistake – это общая (распространённая) ошибка
Assumption – предположение
Evil – зло; злой; зловещий
Go through with – доводить до конца; завершать
That's brilliant – это гениально
Far too much – слишком много
The cat can be thought of as both alive and dead – об этом коте можно думать как о живом, так и о мёртвом
Attendant – сопровождающий; сопутствующий
Attendants – обслуживающий персонал
Affect – волновать; трогать; задевать; затрагивать; назначать; предназначать
Affected – тронутый; задетый; находящийся под влиянием; предназначенный
Undue – непомерный; чрезмерный; несвоевременный; неуместный
Ease – лёгкость; простота; естественность; беззаботность
Omit – пропускать; не включать; упускать
Exertion – напряжение; усилие
Consume – тратить; расточать; расходовать; истреблять
Consumed – расходуемый; потребляемый
Weave – узор; переплетение; плести
Grasp – схватывание; хватка; понимание; схватить; понять; осознать
To yield – давать результат; приводить к чему-либо; уступать; сдаваться; поддаваться
Suspend – откладывать; приостанавливать
Entail – влечь за собой; вызывать; навлекать
Horrendous – страшный; ужасный
Reticent – молчаливый; немногословный; умалчивающий
Choke – удушье; удушение; душить
Bloody – кровавый; чёртов
Ruddy – чёртов
Adjust – приводить в порядок; подгонять; приспосабливать
Mate – приятель; напарник; спариваться
Confirm – подтверждать
Resemble – быть похожим; походить на
In the light of this – в свете этого
Ongoing – происходящий в настоящее время
Stance – поза; позиция; установка
Bestiality – скотство; зверство
Depict – рисовать; описывать; изображать
Depiction – изображение; описание
Suggestive – вызывающий мысли; намекающий на непристойное; неприличный
Folk – люди; родня; народный
Get up! – вставай!
Warm up – разогреть
Heat up – нагреть
Speak up! – говори громче!
Go up – двигаться вверх; возрастать
Grow up – вырастать (по отношению к людям)
Grown-up – выросший
Count up to five – досчитайте до пяти
Show up – заявляться; приходить; показываться
Hold up – взять и приподнять; задерживать
to hold up a shop – ограбить магазин
hold-up – ограбление
venture – рискованное предприятие; рисковать; отважиться; решиться
joint – стык; сочленение; соединение; общий; объединённый; совместный
nasty – вульгарный; отвратительный; непристойный; неприятный; скверный
stern – строгий; суровый; твёрдый; решительный
a stern resolve – твёрдое намерение
laid-back – спокойный; неторопливый
zero tolerance policy – политика нулевой терпимости
vindictive – мстительный
let off – выстрелить; прощать
hook – крюк; крючок; короткий боковой удар
grind – размалывание; скучная работа; долбёжка; зубрёжка
aww, that's so sweet – ах, это так мило
aww, shucks! – ах, чёрт!
Blizzard – снежная буря; буран
Vignette – виньетка
Spotlight – точечный свет; осветить; сделать центром внимания
Pattern – образец; шаблон; узор
Frame – рамка; кадр
lay-out – макет; планировка; разметка
vintage – старинный; классический; старомодный
blur – пятно; неясные очертания
blurry – неясный; расплывчатый; смазанный
blurred – неясный; расплывчатый; смазанный
palette – палитра; цветовая гамма
complementary – дополнительный
triad – трёхзвучие; триада
monochromatic – монохроматический; одноцветный
ain't – are not; am not; is not; have not
crook – крюк; крючок; искривлять
rumble – громыхание; громыхать; греметь
attitude – позиция; отношение
swallow – глоток; глотание
hazardous – опасный; рискованный
citing – цитирование; ссылка; цитата
morning! – доброе утро!
See you later – увидимся позже
Departure – отъезд; уход; отбытие; отправная точка
watch out – остерегаться; быть начеку
cute – изящный; привлекательный; прелестный; проницательный; сообразительный; находчивый; умный
prominent – выступающий; заметный; видный; выдающийся; знаменитый
so long – пока; до свидания; прощайте
Pal – друг; приятель; товарищ; дружить
Alert – тревога; бдительный; настороженный; поднимать тревогу
Altitude – высота; возвышенность; высокое положение
Patch – клочок; лоскут; обрывок; заплата; чинить; латать
Booze – спиртное; бухло
Troop – стадо; отряд; группа людей; войска
Suit – прошение; обращение; ухаживание; комплект; набор; костюм; подходить; соответствовать; устраивать
Silly – глупый
What the hell? – какого чёрта?
Mess – беспорядок; путаница; неприятность; создавать беспорядок; валять дурака
get into a mess – попасть в беду
mess up – портить
don't mess with me – не валяй дурака со мной	
favour – расположение; благосклонность; поддержка; одобрение; любезность; одолжение
do me a favour – сделай мне одолжение
footage – длина плёнки в футах; метраж; отснятый материал фильма
explode – взрывать
exploded – разобранный
rendering – передача; интерпретация; визуализация
am I right? – я прав?
Let me handle this – давай я разберусь с этим
Associate – товарищ; коллега; партнёр; объединённый; связанный; объединяться; связывать; ассоциировать
Associated – объединённый; связанный
Amaze – изумлять; поражать; удивлять
Amazing – изумительный; ошеломительный; удивительный
Exclude – исключать
Don't be late! – не опаздывай!
hang on – прицепиться; повиснуть; крепко держаться
to relive – вновь пережить
I'm racking my brain – я напрягаю мой мозг
Performer – исполнитель (задания); актёр
Performance – исполнение; выполнение; деятельность; производительность; результативность; эффективность
Chill – холод; холодный; охлаждать
Chill out – успокаиваться; остывать
Caution – внимательность; осторожность; предостережение; предостерегать
Advance – движение вперёд; продвижение; двигать вперёд; продвигать
Impact – удар; толчок; импульс; влияние
Bound – граница; рамки; ограничение; несвободный; связанный; ограничивать; сдерживать
Obtain – получать; добывать; достичь; достигать
Take it out of here – забери это отсюда
It's your choice – это твой выбор
So, what's it gonna be? – так как это будет?
Flame – огонь; пламя; гореть; пылать
Passion – страсть
Excitement – волнение; возбуждение
Trainee – практикант; стажёр
Chapter – глава
Build – внешний вид; форма; конструкция; строить; сооружать
Build on – основываться на; надстраивать
Web framework built on the Servlet API – веб фреймворк, основанный на Servlet API
From the very beginning – с самого начала
Commonly known – общеизвестен
Also based on – также основан на
To cover – покрывать; охватывать
This section covers Spring Web MVC – этот раздел охватывает Spring Web MVC
Baseline – база; базис; базовый
Range – круг; диапазон; ряд; ассортимент; варьироваться; простираться
Design – разработка; дизайн; проектирование; конструкция; конструкторский; разрабатывать; проектировать; конструировать
Share – доля; часть; участие; долевой; делить; разделять; распределять
Shared – общий; совместный
Flexible – гибкий; гибкость
Diverse – различный; разнообразный
Workflow – рабочий поток
And more – и больше; и так далее
That in turn – это, в свою очередь
According – согласно
Declare – декларировать; объявлять; заявлять
Initialize – инициализировать
Pay – плата; оплата; зарплата; платить; оплачивать; вознаграждать
Excellent – отличный; отменный
Excellently – отлично
Perfectly – отлично; совершенно
Very well – отлично
Very good – очень хорошо
In general – вообще
Mainly – в основном; преимущественно; главным образом
Principally – в основном; главным образом
Basically – в основном; по существу
Urgent – срочный; неотложный
Typically – как правило; обычно
Shield – щит; защита; защищать; ограждать
However – однако; тем не менее
Perk – привилегия; преимущество
Participate – участвовать; принимать участие
Credentials – полномочия
As a reminder – как напоминание
Variety – разнообразие; разнообразные; различные
With the use of – с использованием (чего-то)
Using – с использованием (чего-то)
With the application of – с применением (чего-то)
A wide range of – широкий круг (чего-то)
In various areas – в разных областях
In various ways – по разным направлениям
In different directions – по разным направлениям
For a noise immunity increase – для увеличения помехозащищённости
Increase – возрастание; рост; увеличение; возрастать; увеличиваться
Against a background of – на фоне (чего-то)
Subject areas – предметные области
Schedule – план работы; график; составлять расписание; намечать; планировать
Activity – деятельность
Guidance – методические указания
Methodological guidelines – методические указания
Laboratory – лаборатория; лабораторный
As follows – следующим образом; а именно; таковы
Principal – основной; главный; главное
Firm – фирма; крепкий; твёрдый
The same as if – то же самое, как если бы; такой же, как если бы
Note that if – замечу, что если …
While – время; пока; хотя; тогда как
While doing smth – при делании чего-то
Negotiation – переговоры; обсуждение; согласование
Negotiate – вести переговоры; договариваться
Also known as – также известен как
Dedicate – посвятить
built-in – встроенный
pluggable – сменный; съёмный
hand over – передавать (из рук в руки)
parsing – разбор
ridiculous – смешной; нелепый
conquest – победа; завоевание
misery – страдание
wreck – крушение; авария
tutor – наставник; репетитор
approximately – примерно; приблизительно
about – около; примерно; приблизительно; об
around – вокруг; около; примерно; приблизительно
artificial – искусственный
artificial intelligence – искусственный интеллект
That way – так; таким образом; туда
I'll do my best – я сделаю всё, что в моих силах
Co-founder – соучредитель
Fluency – плавность; беглость
Grammar – грамматика
Meaning – значение; смысл
Vocabulary – словарь; словарный запас; лексика
Well, actually that's kind of a trick question – ну, в действительности это своего рода вопрос-обманка
Meaningful – выразительный; многозначительный
Habit – привычка; обычай; традиция
Prevent – предотвращать
Towards – в направлении; перед
Capture – захват; сбор; улавливание; захватить
Over and over again – снова и снова
Of all time – за всё время
Regularly – регулярно
Grace – грация; изящество
Unmatched – несравненный; непревзойдённый
Failure – неспособность; неудача; провал
Discourage – обескураживать; препятствовать; сдерживать
Another – другой; ещё один
Invention – изобретение
Eventually – в конце концов
Obstacles didn't make him give up – препятствия не заставили его бросить
Clearly – чётко; явно; ясно; очевидно
That's why I succeed – вот почему я добился успеха
He had a healthy relationship with failure – он имел здоровое отношение к неудаче
He saw failure as a step towards success – он смотрел на неудачу, как на шаг в направлении успеха
This way of thinking eventually led him to success – такой образ мышления в конце концов привёл его к успеху
Persevere – упорно продолжать
This attitude of seeing failure as a learning experience helped me persevere – такое отношение к встречающейся неудаче как к обучающему опыту помогло мне упорно продолжать
Perversion – извращение
Pervert – извращенец; извращать
Deprave – развращать
Depraved – развращённый; порочный
Good luck! – удачи!
Method is worth special attention – метод стоит специального внимания
In particular – в частности
Overhead – верхний; накладные расходы
Community – сообщество
Bind – связать
Usability – пригодность; удобство использования
Functionality – функциональность
As mentioned before – как упомянуто ранее
Let's start with – давайте начнём с
Merge – объединить; сливаться
Concise – краткий
Simply put – просто излагая; проще говоря
Rest – отдых; остаток; отдыхать
Almost – почти
Otherwise – иначе
Deprecated – не рекомендуется
Desperate – отчаянный; отчаявшийся
Corresponding – соответствующий
I missed you – я скучал по тебе
Consider – рассмотреть; рассматривать; считать
Rough – грубо; грубый; приблизительный
As soon as – как только
But these weren't the only things that made him great – но это не были единственные вещи, которые сделали его великим
He wasn't discouraged by failure – его не обескураживала неудача
He knew that failure was just another chance for him to improve – он знал, что неудача была лишь ещё одним шансом для него, чтобы совершенствоваться
There was always a problem – всегда была проблема
There were always problems – всегда были проблемы
Convince – убеждать
Humble – скромный
Pursuit – достижение; достижения
Tip – чаевые; совет; кончик; наводка; подсказка
Hold on – подождать; держаться; продержаться
Restlessness – беспокойство
Wealth – богатство
Wealthy – богатый
Mimic – имитировать
Robust – надёжный; активный; устойчивый
Facilitate – способствовать; содействовать
Validate – проверить; подтвердить; подтверждать
Revalidate – подтвердить; подтверждать
Disable – отключить; отключать
Exchange – обмен
He came to a similar conclusion – он пришёл к подобному заключению
After trying to find – после попыток найти
Executive – исполнительный; руководитель
Asset – актив; имущество; ресурс
Chord – струна; аккорд
Struck a chord – задело
One by one – один за одним
By mistake – по ошибке
The time had come to say goodbye – пришло время сказать прощай
And then smth happened – и затем кое-что произошло
All of this – всё это
All of these – все эти
All of them – все они
All of us – все мы; всех нас
Out of the box – из коробки
Swap – обмен; обменять; заменить
Complexity – сложность
Research – исследование; исследования; исследовать
Possibility – возможность
Solve – решить; решать; урегулировать
Solving – решение; разрешение; урегулирование
Based on – на основе
Downside – обратная сторона; недостаток
Justify – оправдать; обосновать
Scattered – разбросанные
Leverage – использование; влияние; привлечение
External – внешний; наружный
Thank you so much – большое спасибо
Thank you very much – большое спасибо
Thanks a lot – большое спасибо
Survey – исследование; обследование; обзор; опрос
Insight – понимание
Implication – последствие
Implicated – причастны к; замешаны
pros and cons – плюсы и минусы; преимущества и недостатки
forgery – подделка
boost – повышение; импульс; стимул; толчок; повысить; увеличить; стимулировать; активизировать
blueprint – план; проект; программа; концепция
networking – сеть; сетевой; создание сетей; налаживание связей
follow up – отслеживание; отслеживать
approve – утвердить; одобрить
approval – утверждение; одобрение
challenge – проблема; задача; вызов; трудность; оспаривание; оспаривать; бросать вызов
feed – корм; питание; канал; кормить; питаться
RSS feed for this post – RSS канал для этого поста
Feedback – отзыв; отклик; обратная связь
Spoil – портить; испортить
Moan – стонать
Moaning – стон
Subtle – тонкий; едва уловимый
Hood – капюшон; капот
Under the hood – под капотом
Storage – хранение; хранилище
Strict – строгий
Surveillance – слежение; наблюдение
Introduce – представить; ввести
Whenever – когда; как только; всякий раз
Drift – дрейф; смещение; дрейфовать
Greater than or equal – больше или равно
Expectation – ожидание
Strive – стремиться; добиваться
Striving – стремление
Content – контент; содержание; довольствоваться
As opposed to – в противоположность к; а не
Harvest – урожай; собирать
Influential – влиятельный
Distinguish – отличать; различать
Indistinguishable – неразличимый
Qualify – квалифицировать
Proponents – сторонники
on the right track – на правильном пути
even though – даже хотя
the world as it truly is – мир как он реально есть
some have even gone as far as – некоторые даже пошли дальше
only a one in a billion chance – только один шанс из миллиарда
keep in mind – держите в уме
because of this – из-за этого
to determine the destination – определить место назначения
somewhat – довольно; отчасти; в некоторой степени
that even if – что даже если
to each of us – для каждого из нас
citizen – гражданин
citizenship – гражданство
punch – удар; пунш; ударить
pleased as punch – доволен как пунш
upset the apple cart – создавать сложности (расстраивать корзину яблок)
hacking – взлом
life hacking – хитрость жизни
overcome – преодоления; преодолеть
revise – пересмотреть; исправить
revising – пересмотр
edit – редактировать
editing – редактирование
edition – издание
guardian – опекун; хранитель; защитник
honored – почётный; польщён
I'm honored – это честь для меня; я польщён
Distinction – отличие; различие; различия
Unlike – в отличие от
Participant – участник
Inheritance – наследование; наследство
Interlocking decisions – взаимосвязанные решения
fanned the flames – раздули пламя
foreigner – иностранец
sore – боль; больной; болит
sore spot – больное место
bizarre – странный
stress – стресс; подчеркнуть; подчёркивать
rage – гнев; ярость
By the same token – в то же время; к тому же
Compassion – сострадание
Contribute – способствовать; содействовать; вносить вклад
Nor will she need – не будет ей нужен и
Fool – дурак; глупец; обмануть; одурачить
Conversation – разговор; беседа; общение
Identity – индивидуальность; личность; идентичность
Technique – техника; методика
Squash – раздавить
Get good enough – становятся достаточно хороши
Neither can they possess – не могут они обладать и
Over the next three years – за следующие три года
On my part – с моей стороны
It's just a misunderstanding on my part – это просто непонимание с моей стороны
Stage – этап; стадия; сцена; выставлять; демонстрировать
Outline – план; проект; набросок; изложить; наметить
Scenario – сценарий
Occur – происходить; возникать; иметь место
Occurring – происходят; происходящие; возникающие
Speed up – ускорить
Proven – проверенный; доказанный
Ad-hoc – специальный
Over time – со временем
Intent – намерение; цель
Intention – намерение; цель
Related objects – связанные объекты
Procreate – порождать; размножаться
Rabbit – кролик
Throughout – на всём протяжении; на всей территории; повсюду в
Indirection – уклончивость; косвенная адресация
Wholesale – оптом
Pervasive – повсеместный; широко распространённый
Encapsulation – инкапсуляция; сокрытие
Derived – производный; вытекающий
Map out – наметить; начертать
Retire – уволиться; удалиться
Competition – конкуренция; конкурс; соревнование
Competitor – конкурент
Contest – конкурс; соревнование
Profitable – прибыльный; выгодный
start out – начинать с
evolve – развиваться; эволюционировать
exposure – воздействие; подверженность
defer – отложить; отсрочить
outstanding – нерешённый; остающийся; выдающийся
outstanding contributions – невыплаченные взносы
contribution – вклад; взнос; участие; содействие
specify – указывать; определять; конкретизировать
supply – поставка; снабжение; предоставление; поставлять; предоставлять
routinely – обычно
overlap – дублирование; дублироваться; пересекаться
For that reason – по этой причине
Matter – вопрос; проблема; дело; предмет; материя
No one else – никто больше; никто другой
Dude – парень; чувак
Cheers – урра; спасибо; твоё здоровье; будь здоров
Cheers to – выпьем за
Although – хотя
Measure – мера; измерение; меры
Aggregate – совокупный
Aggregation – объединение; обобщение; скопление
Step by step – шаг за шагом
Under the control – под контролем
Competing – конкурирующие
Representation – представление; представительство
Agility – ловкость
Agile – ловкий; проворный
Property – свойство; собственность; имущество
Feature – особенность; черта; характеристика; свойство; фича
Character – характер; персонаж
Warrior – воин
Wizard – колдун; чародей; волшебник
Warlock – колдун; чернокнижник
Leather – кожа; кожанный
Skin – кожа
Enforcement – исполнение; применение; соблюдение; принуждение
Assign – назначать; поручать
Assigned – назначенный
Accessor function – функция доступа
Harmful – вредный; пагубный
Designate – назначать
Spawn – отродье; порождение; порождать
Anticipate – ожидать; предвидеть; прогнозировать
Scratch – царапина; чесать; царапать
From scratch – с нуля; с чистого листа
Most likely – наиболее вероятно
Creepy – жуткий
Creep up on – подкрадываться к
Populate – заполнять; заселять
Registry – реестр; регистр; регистрация
Register – реестр; регистр; регистрация; регистрировать
coherent policy – согласованная политика
react – реагировать
respond – ответить; отреагировать
complement – дополнение; дополнять
supplement – дополнение; дополнять
addition – дополнение; добавление
predict – предсказать; предсказывать
prediction – предсказание; прогнозирование
predicate – сказанное, заявленное (утверждение); основные
expertise – опыт; экспертиза; квалификация; компетенция
substitution – замена; замещение
as many as possible – так много как возможно
current affairs – текущие новости
native speaker – нативный спикер (носитель языка)
practice makes perfect – практика делает совершенным
not do much for – не делает много для
on one's own – самостоятельно
read lips – читать по губам
constitute – составлять; являться; представлять собой
capability – потенциал; возможность; способность
affair – роман; связь; интрижка; отношения
affairs – дела; вопросы
unpredictable – непредсказуемый
wisdom – мудрость
for sale – на продажу
rule – правило; правление; управлять
go for a walk – идти на прогулку
sometimes – иногда; порой; временами
courageous – отважный
each other – друг друга
it's not my fault – это не моя вина
speak for – высказываться в защиту
attentively – внимательно
educational institution – учебное заведение; образовательное учреждение
levy – налог; сбор; взимать
scale – масштаб; шкала; масштабировать
graph – граф; график; диаграмма
monitoring – контроль; мониторинг; наблюдение; отслеживание
optional – опциональный; дополнительный; необязательный
observers register themselves – наблюдатели регистрируют себя сами
discretion – усмотрение
left to the discretion of the designer – оставлены на усмотрение дизайнера
consecutive – последовательные; подряд
on the other hand – с другой стороны
address – адрес; решение; рассмотрение; устранение; удовлетворение; рассматривать; решать
undo – отменить
queue – очередь; стоять в очереди
receiver – приёмник; получатель
separation – разделение
signature – подписание; подпись; сигнатура
opaque – непрозрачный
consort – супруг
she is worth listening to – к ней стоит прислушиваться
crop – урожай
help out – выручать
take pity on – сжалиться над
we'll see about that – мы ещё посмотрим
literally – буквально; в прямом смысле
coming right up – сейчас будет
out of envy – из зависти
steal – красть
struggle – борьба; усилия; бороться
are you in a hurry? – ты в спешке?
Meeting – совещание; встреча; собрание
Hint – намёк; подсказка
Rare – редкий
Greet – приветствовать
Coupling – сцепление; соединение; связывание
Chain – цепь; цепочка; приковывать; соединять в цепь
Sender – отправитель
Damage – ущерб; повреждение; вред; повредить
Pipeline – канал; трубопровод
Pipeline mode – конвейерный режим
Pipeline architecture – конвейерная архитектура
Contain – содержать; включать
Traversal – прохождение; обход
Recursive traversal – рекурсивный обход
Potentially – потенциально; возможно
Node – узел
Wiring – проводка
Hard-wiring – жёсткое связывание
can be configured dynamically – могут быть сконфигурированы динамически
simplify – упростить
successor – преемник
entrance – вход
entry – вступление; ввод; доступ; вход
entry point – отправной пункт; точка входа
careful – осторожный; внимательный; тщательный; осторожно; внимательно; тщательно
passed on – передаётся; передан
usually – обычно
return – возвращение; вернуться; возвращаться
assess – оценивать
provide – представить; предоставить; обеспечить; оказывать; предусматривать
turn – поворот; очередь; повернуть; превратить
turn on – включить
allege – утверждать
alleged – предполагаемых
alleged crimes – предполагаемых преступлений
alleged victims – предполагаемых жертв
spread – распространение; распространяться
spreading rumours – распространение слухов
dawn – рассвет
howdy y'all, my friends – приветствую вас, мои друзья
he has bought – он купил (результат)
on the right – справа; направо
subordinates – подчинённые
wear – носить; надеть; одевать
it's a hit below the belt – это удар ниже пояса
interaction – взаимодействие
interact – взаимодействовать
promote – способствовать; содействовать; поощрять
vary – варьироваться; различаться; меняться
intermediary – посредник; посредничество
peer – сверстник; равный; ровня; коллега
piece – кусок; часть
peace – мир; покой; спокойствие; мирный
phenomenon – явление; феномен
granularity – детализация
affiliation – принадлежность
affiliate – филиал
affiliated – связаны; ассоциированы
couple – пара; связываться; соединяться
coupled – связанный; сочетаемый
alternate – альтернативный
simultaneously – одновременно
Partition – раздел; разделение
Partitioning – разделение
Proliferate – распространяться; разрастаться
Conduct – поведение; проведение; ведение; проводить
Mutual – взаимный; обоюдный
Identify – идентифицировать
Benefit – пособие; льгота; польза; выгода
vice versa – наоборот
arbitrary – произвольный
generalization – обобщение
specialization – специализация
superior – высший; вышестоящий; превосходящий; старший
patience – терпение
Haven't you forgotten anything? – вы ничего не забыли? (результат)
Look out for – присматривать
quickly – быстро
alone – один; одна; одну
by far – намного; безусловно
wrap up – закончить
season – сезон
temper – характер; самообладание; нрав; темперамент; терпение
I'm about to lose my temper – я вот-вот потеряю моё терпение
Dissertation – диссертация
Thesis – диссертация; тезис
Report – доклад; отчёт; сообщение; докладывать; сообщать
Paper – документ; бумага; доклад; статья
Presentation – представление; презентация; выступление; доклад
Computation – расчёт; вычисление
Computational – вычислительный
Alter – изменить; менять
Statement – заявление; изложение; утверждение; показание
Limb – конечность
Stick – палка; держаться; воткнуть; засунуть
Effort – усилие
Future efforts will be focused on – будущие усилия будут сфокусированы на
Propose – предлагать
Effectiveness – эффективность
Robustness – устойчивость
Extract – экстракт; извлечение; извлекать
Extraction – извлечение
Due to – благодаря; по причине; за счёт
The next goal is – следующей целью является
Modern – современный
Often – часто; зачастую
The purpose of this activity is – целью этой деятельности является
The objective of this paper is – целью этой статьи является
This work is aimed at – эта работа нацелена на
The aim was – целью было
Aim – цель; задача; целиться
Separately – отдельно; раздельно
Curve – кривая
During – во время
Fully – полностью
Completely – полностью; совершенно
Algorithm – алгоритм
Forecast – прогноз; прогнозирование
Weather forecast – прогноз погоды
Purse – кошелёк; сумочка
Sweetheart – возлюбленная; дорогой; дорогая; милый; милая; дорогуша
Darling – дорогой; дорогая; милый; милая; дорогуша
Honey – милый; милая; сладкая; медовая
For some reason – по некоторой причине
Elder – старший
Shine – светить; сиять
Let him down – подвести его
Make up – составлять
Be made up of – быть составленным из
Common – общий; распространённый; обычный; община
Chamber – камера; палата; зал
Early – рано
I can't wrap my head around – я не могу охватить моей головой
Ought – должен; следует
Parent – родитель
Employ – использовать; применять; нанимать
Generic – общий; типовой
Restriction – ограничение
Digit – цифра
Skeleton – скелет
Expand – расширять
Expend – тратить; расходовать
Invariant – неизменный
Mandate – мандат; полномочия; давать полномочия
Affectionate – любящий; нежный
Affectionately – нежно; с любовью
Label – этикетка; ярлык; маркировка; маркировать
Labelled – маркированный
Examine – изучить; рассмотреть; проанализировать
Shell – корпус; оболочка; скорлупа
Type – тип; ввести; печатать
Universe – вселенная
Suggest – предлагать; предполагать; советовать; указывать
Score – счёт; выиграть
Importance – важность
In accordance with – в соответствии с
Person – персона; человек; личность
look up to – равняться на
in sight – в поле зрения
phone – телефон; звонок; звонить
weigh – весить
weight – вес
liar – лжец; лгунья
enter – ввести; вступать; войти
coast – берег; побережье
defeat – поражение; нанести поражение
nod – кивок; кивнуть
invader – захватчик
encouragement – поддержка; поощрение
goal – цель; гол; ворота
countryman – соотечественник
closer – ближе; близкий; близко
fabled – легендарный
trophy – трофей
settle – урегулировать; уладить; поселиться; обосноваться
sparkling – игристый; сверкающий; блестящий
dissect – вскрывать; препарировать
deadlock – тупик; затор
brave – храбрый; смелый
bravely – храбро; смело
convert – конвертировать; преобразовывать
glory – слава
glorious – славный; великолепный
circumstance – обстоятельство
blow – удар; взорваться; взрывать; дуть; отсасывать
to one another – друг другу
robbery – ограбление
robber – грабитель
robbed – ограбленный
dangerous – опасный
district – район
at all times – всегда
forward – вперёд; передовой; направлять
in front of – перед
in front of him – перед ним
hardly – с трудом; вряд ли; едва
crush – раздавить
perfume – аромат
smell – запах; пахнуть; нюхать
stink – вонь; вонять
at one time – однажды; одновременно; за один раз
allocate – выделять; распределять
beyond – за пределами; после; вне
source – источник; исходный
squad – команда; отряд
interchangeable – взаимозаменяемый
bury – захоронить; закопать; зарыть
upheaval – потрясение
cohesion – сплочённость; единство
exhortation – призыв
exercise – осуществление; реализация; деятельность; упражнение; осуществлять
crow about – хвастаться
sick – больной; болеть
loss – потеря; утрата
at a loss – в недоумении
leave – оставлять; покидать
leave for – отправляться (куда-то)
favourite – любимый
favorite – любимый
band – группа
serve – служить; обслуживать
former – бывший; прежний; первый
In the former case – в первом случае
Latter – последний; второй
In the latter case – в последнем случае
Subway – метро; подземка
Gut – чутьё; интуиция; нутро
to some degree – в некоторой степени
differ – различаться
minority – меньшинство
frustration – разочарование; фрустрация
pounce – наброситься; атаковать
charming – очаровательный; обаятельный
notorious – пресловутый; печально известный
well-connected – с хорошими связями
corroborate – подтвердить; подтверждать
verge – грань
on the verge – на грани
aggravate – усугубить
aggravating – усугубляющий; отягчающий
seriously – серьёзно
sweep – подметать; прочёсывать
drug – наркотик
plea – призыв; заявление; просьба
bleak – мрачный; безрадостный
fold – сложить; складывать
unfold – разворачивать; разворачиваться; открываться
crumble – рушиться; рассыпаться
cry – плач; плакать
remorse – раскаяние
tampering – вмешательство
evidence – доказательство; улика; свидетельство
evidence tampering – фальсификация доказательств
put a hold on – приостановить; отложить
controversy – спор; противоречие; разногласия
swing – качели; размах; свинг; качаться
naughty – непослушный; озорной; шаловливый
compel – заставить; вынудить
compelled – вынужден
penalty – наказание; штраф; пенальти
negligible – незначительный
wonder – чудо; удивление; удивляться
ruse – уловка
blatant – вопиющий; явный
appeal – призыв; обращение; апелляция; обжалование; обжаловать; обращаться; взывать
appealing – привлекательный; призывающий
evaluation – оценка; анализ
evaluate – оценивать; анализировать
calculation – расчёт; вычисление
calculate – рассчитать; вычислить
disease – болезнь
pupil – учащийся; ученик
desert – пустыня
dunno – не знаю
pace – темп; скорость
couch – диван
coach – тренер
make sense – иметь смысл
get over – пережить; преодолеть; забыть
jewelry – драгоценности; украшения
kick – удар; пнуть; ударить
kick out – выгнать; вышвырнуть
trash – мусор; отбросы
blossom – цветок; цвести
accident – авария; несчастный случай; происшествие; случайность
accidentally – случайно; нечаянно
sequentially – последовательно
full object status – внутреннее состояние объекта
transparently – открыто; прозрачно
depending on what – в зависимости от того, что
bloat – раздувать
The key idea – ключевая идея
Permutation – случайная перемена; перестановка
Blast – взрыв; взорвать
Nemesis – заклятый враг
Fear – страх; страшиться; пугать
Intriguing twist – интригующий поворот
Urging – настойчиво призывая
Bait – приманка; наживка
Delight – восторг; радость; наслаждение
line up – построиться в линию
threat – угроза; угрожает
distract – отвлечь; отвлекать
juggle – жонглировать
premise – предпосылка
confusing – запутанный
illogical – нелогичный
dial – набор; набрать номер
reception – приём; стойка регистрации
tune – мелодия; настроить
tuned channel – настроенный канал
internal – внутренний
attain – достичь; добиться
by no means – никоим образом
kindness – доброта
squabble – ссора; ссориться; вздорить
cheap – дешёвый
organize – организовать
unbelievable – невероятный
unbelievably difficult – невероятно трудно
fiery – огненный; пламенный
vow – клятва
vowed – поклялся
showdown – противостояние
that's cool – это круто; это здорово
resume – резюме; возобновить
rivalry – соперничество
suffer – страдать; подвергаться
exact – точный; конкретный; требовать
knock – стук; стучать
knock out – выбить; вырубить
transition – переход; преобразование
disadvantage – недостаток
siblings – братья и сёстры; родственники
accompany – сопровождать
neat – аккуратный
neatly – аккуратно
compartment – отсек; отделение
inventory – перечень; реестр; запасы
currency – валюта
deposit – вклад; депозит
selection – выбор; отбор; подбор; выделение
depletion – истощение
what do I owe you? – что я вам должен?
Falsely – ложно
Collect – собирать; забрать
search for – искать тщательно
advisable – рекомендуемый; целесообразный
it is advisable to take notes – рекомендуется делать заметки
fight – борьба; бой; драка; битва; ссора; бороться; сражаться
concede – признать; уступить
remarkable – замечательный; выдающийся
decline – сокращение; снижение; уменьшение; спад; сокращаться; снижаться; уменьшаться
audacity – смелость; наглость; дерзость
part – часть; участие; роль; разделяться; расставаться
to play an active part – играть активную роль
ugly – уродливый
creature – создание; существо
scream – крик; кричать
stay up – остаться; не спать
stay up working – оставаться работающим
wallet – бумажник
all day long – весь день
dispatch – отправка; диспетчер; направить; отправить
primary – первичный; основной; главный; главное
prohibitive – запретительный; непомерно высокий
acknowledged – признанный
rationale – обоснование; целесообразность
must be interleaved – должны чередоваться/перемежаться
resorting – применение; использование
Suppose – полагать; предполагать; предположим
Accrual – начисление
Gather – сбор; собирать
Amend – изменить; внести изменения; внести поправки
Amending – внесение поправок
till – до; пока
not until – после
juvenility – юность
rarely – редко
arrive – прибыть; приехать
by the time – к тому времени, когда
eat – есть; съесть
battle – битва
disobey – не подчиняться
How dare you disobey my orders? – Как смеешь ты не подчиняться моим приказам?
Behind – позади; сзади
Puncture – прокол; прокалывать
Escape – побег; бегство; сбежать; избежать
Futile – бесполезный; тщетный
Overlook – упускать из виду; игнорировать
Exasperate – сердить; раздражать
Grim – мрачный
Mortal – смертный; смертельный
Flesh – плоть
Brittle – хрупкий
Shiver – дрожать
Drag – тащить
Glow – светить; сиять
Clumsy – неуклюжий
Oblivion – забвение
Nightmare – кошмар
watch on – следить за; смотреть по
play out – разыграть; играть на улице
disgrace – позор; бесчестие
rip – вырвать; оторвать; разорвать
rip away – разрушить
back – обратно; назад; спина; поддержать; возвращаться
rival – соперник; конкурент; конкурировать; соперничать
howl – вой; выть
pride – гордость
shame – стыд; позор
dash – тире
prone – склонный; подверженный; лицом вниз
up-to-date – современный; новейший; обновлённый; актуальный
thread – нить
diary – дневник
pass by – проходить мимо
for all I know – насколько я знаю
verb – глагол
switch – выключатель; переключатель; переключение; переключаться; поменяться
switch on – включить
hurry up! – поторопись!
Pool – бассейн; пул; резерв; бильярд; объединить
Freedom – свобода
Converse – обратное; разговаривать; общаться
Awake – проснуться; бодрствовать; бодрствующий
Committee – комитет
Agree – согласится
He agreed on the whole with the draft proposal – он согласился, в целом, с эскизным предложением
Fence – забор; заграждение; ограда
Surroundings – окрестности
Finally – наконец; в заключение; в конце концов
Review – обзор; рассмотрение; пересмотр; анализ; рассмотреть; пересмотреть; проанализировать
Article – статья
Strange – странный; чужой; незнакомый
Freeze – замораживание; заморозить
look away – отвернуться
information on this project can be sent on demand – информация по этому проекту может быть отправлена по запросу
except – за исключением; кроме; только
hire – нанять; нанимать
out of the question – не обсуждается; исключено
delicious – вкусный; восхитительный
suspicious – подозрительный
bet – ставка; пари
I bet – держу пари; готов поспорить
Vote – голос; голосование; голосовать
Neighbour – сосед
Expel – высылать; изгонять; исключать
Always – всегда
Nail – гвоздь; ноготь; пригвоздить
Sin – грех; грешить
Needle – игла
Flat – квартира; фиксированный
Wash – мыть
Farther – дальше
Forever – всегда; навсегда; вечно; навечно
Guilt – вина
Guilty – виновный; виноватый
Grief – горе
Handy – удобный
Incompatible – несовместимый
Elusive – неуловимый; недостижимый; иллюзорный
Alignment – согласование; выравнивание
Misalignment – несоответствие
Incongruity – несоответствие; несовместимость
Reconcile – примирить; совместить; согласовать
Insulation – изоляция
Hardening – ужесточение; укрепление
Compose – составлять; сочинять
Lock – замок; запирать
Explosive – взрывчатка; взрывной
numerous implementations – многочисленные реализации
Embellish – украшать; украсить; приукрасить
Topic – тема; вопрос; признак; тематика; предмет
Be fond of – быть в восторге от
Refuse – отказываться; отказать
Uniformly – единообразно; одинаково; равномерно
Across – через; между; среди
across all primitive objects – среди всех примитивных объектов
safety – безопасность; охрана; защита
heuristic – эвристический
assembly – собрание; ассамблея; сбор; сборка
embellishment – украшение; приукрашивание
alternative – альтернатива; альтернативный
assault – нападение; посягательство
accurate – точный
silence – молчание; тишина
silent – молчаливый; тихий
devastate – опустошать; разрушать
devastating – опустошительный; разрушительный; губительный
seldom – редко
race – раса; гонка
civil – гражданский
servant – слуга; служащий
were twice as likely – были в 2 раза вероятней
detrimental – ущерб; пагубный
fined – оштрафован
common sense – здравый смысл
overall – общий; всеобщий; целый; совокупный
advocate – адвокат; защитник; сторонник; выступать за; отстаивать; поддерживать
oracle – оракул; пророк
tame – приручить; укротить
billing – выставление счетов
condition – условие; состояние
reserve – резерв; запас; резервирование; зарезервировать
decent – достойный; приличный; порядочный
decadence – упадок
check up – проверять; контролировать
nag – пилить; ворчать
surrogate – суррогатный; замещающий
instigate – провоцировать; подстрекать
instigating – провоцирующий; подстрекающий
interpose – вставлять
freed – освобождённый
funds – средства; фонды
extrinsic – внешний
intrinsic – внутренний
restrain – сдерживать; ограничивать
around the corner – за углом
handshake – рукопожатие
wooden – деревянный
nowhere – нигде; некуда; никуда
take part – принимать участие
cautious – осторожный
slack – послабление; поблажка; расслабиться
slacking off – расслабился; разленился
leisure – досуг; отдых
leisurely – неторопливый
midday – полдень; полуденный
nap – дрёма
take a nap – вздремнуть
all in all – в целом; в общем
fairly – довольно; достаточно; весьма; справедливо
strenuous – напряжённый
lazy – ленивый
society – общество; общественность
productivity – продуктивность; производительность
obsess – зацикливаться
obsessed – зацикленный; одержимый
glove – перчатка
lean – наклониться; склониться
lend – одолжить; оказывать; придавать
lend colour to – придавать цвет (чему-то) (делать более правдоподобным)
proof – подтверждение; доказательство; подтвердить; доказать
bulletproof – пуленепробиваемый
novice – новичёк
newbie – новичёк; новенький
kicker – прикол; нападающий
achieve – достичь; добиться
entirely – полностью; совершенно; всецело
task at hand – задача в руке (поставленная задача)
sink or swim – тонуть или плыть (пан или пропал)
for a few hours – в течение нескольких часов
but here's the kicker – но здесь есть прикол
scroll – прокуртка; прокручивать
scrolling – прокрутка
deliberate – преднамеренный; умышленный; сознательный; обсуждать
downtime – простой; свободное время
away – подальше; далеко; отсюда; прочь
what is done cannot be undone – что сделано, то не может быть разделано
apart from – помимо; кроме; наряду с
plenty of time – достаточно (много) времени
expressly – прямо; чётко; конкретно; категорически
after – после
descent – происхождение; спуск; снижение
check out – проверить; посмотреть на; заценить
take over – взять на себя; захватить; занять
offence – преступление; правонарушение; нарушение
hesitate – колебаться; стесняться; сомневаться
intership – стажировка
with a proven track record – с подтверждённым послужным списком
featuring – характеризующийся
liaise – поддерживать связь; контактировать
prioritize – уделять приоритетное внимание; расставлять приоритеты
gratified – удовлетворён
enclose – прилагать; включать
continued – продолжил; дальнейший; постоянный
excellence – совершенство; совершенствование
dear – дорогой; милый; уважаемый
willingness – готовность; желание; стремление
vacancy – вакансия
I've had enough – с меня достаточно
For over – в течение более; уже более
Excess – превышение; избыток; чрезмерный; избыточный
Fee – сбор; плата; гонорар; вознаграждение
Guard – гвардия; стража; охрана; охранник
Baggage – багаж
Fluffy – пушистый
In the way of – в плане (чего-то)
Lesion – повреждение
Tumor – опухоль
Flat rate – фиксированная оплата
on time – вовремя
thanks for reaching out – спасибо, что обратились
confluence – сочетание; слияние
because of you – из-за тебя
lightness – лёгкость
unfakeable – неподдельный
utterly – полностью; абсолютно; совершенно
fortune – состояние; богатство; удача; фортуна
so far – до сих пор; на данный момент
security – безопасность; охрана; защита
express – выразить; высказать
fist – кулак
brick – кирпич
castle – замок
wig – парик
chalk – мел
crown – корона
engine – мотор; движок; двигатель
pillow – подушка
constellation – созвездие
mug – кружка
proud – гордый
tongue – язык
someone – человек; кто-то
worthwhile – стоящий
ghost – дух; призрак
take off – снять; снимать; уходить
belief – вера; убеждение; убеждённость
naive – наивный
estimate – оценка; оценивать
underestimate – недооценивать
arse – задница
spank – шлёпать
spanking – порка
pinch – щипок; ущипнуть
I'm convinced of it – я убеждён в этом
endless – бесконечный; нескончаемый
percussion – ударные
repercussions – последствия
steam – пар; паровой
liable – подлежит; ответственен
liable for punishment – подлежит наказанию
is liable for any troubles – ответственен за любые проблемы
malpractice – злоупотребления
coincidence – совпадение
eclipse – затмение; затмить
twice a week – дважды в неделю
hangover – похмелье
suitcase – кейс; чемодан
meal – еда; пища; питание; блюдо
courtesy – вежливость; любезность
reduce – сокращать; снижать; уменьшать
pretty – довольно; достаточно; весьма; вполне
noisy – шумный
surrender – сдача; капитуляция; сдаваться
lest – чтобы не; иначе
bloom – цветение; цветок; цвести
dare – сметь; посметь
by rote – наизусть; механически
travel – поездка; путешествие; путешествовать
below – ниже
floor – этаж; пол
present – настоящий; нынешний; присутствующий; подарок; подарить
highlight – подчеркнуть; высветить; привлечь внимание
within – в рамках; в пределах; внутри; в течение
within the framework – в рамках
within 5 days – в течение 5 дней
conference – конференция
international – международный
scientific and technical – научно-технический
pitch – подача; презентация
by accident – случайно
He is always very thorough in his work – он всегда очень тщателен в своей работе
plead guilty – признавать себя виновным
speech – речь; выступление
verify – проверить; подтвердить; подтверждать
verified – проверенный; подтверждённый
delusive – обманчивый
hike – поход
occurrence – возникновение; случай; событие; явление; появление
event – событие; мероприятие
occasion – случай; возможность; повод; событие
incident – инцидент; происшествие
case – случай; дело; кейс
simplification – упрощение
spend – тратить; расходовать; проводить
candy – конфета
innocent – невинный; невиновный
sublime – возвышенный
assertion – утверждение
assert – утверждать; заявлять
sense – смысл; чувство
Does that make sense? – это понятно?
Am I making sense to you? – я понятен для вас?
I like your sense of humor – мне нравится твоё чувство юмора
Sensitive – чувствительный
She is very sensitive to criticism – она очень чувствительна к критике
In a sense, you're right – в каком-то смысле вы правы
Nonsense – бессмыслица; чушь
sensible choice – разумный выбор
Makes sense! – имеет смысл! (логично!)
Yeah, that makes perfect sense! – да, это совершенно понятно!
It all makes sense now – теперь всё понятно
It doesn't make any sense! – это не имеет никакого смысла!
It makes no sense! – это чушь!
What you just said makes no sense to me at all – то, что ты сейчас сказал, непонятно мне вообще
Questions? – вопросы?
Realize – понимать; осознавать; реализовать; осуществить
I'm trying to figure out a way to do – я пытаюсь разобраться, как сделать
I finally figured it out! – я наконец выяснил это!
I just figured out what your problem is – я только-что выяснил, в чём твоя проблема
I think I figured out why – я думаю я разобрался почему
Go figure! – поди разберись!
It figures – похоже на то
Fog – туман
I haven't the foggiest idea! – я не имею ни малейшего понятия!
I don't have the foggiest idea what you're talking – я не имею ни малейшего понятия, о чём вы говорите
Charm – шарм; очарование; обаяние; очаровать
Darkness – тьма; темнота
stand out – выделяться
grow – расти; выращивать; становиться
adore – обожать
stubborn – упрямый
fancy – модный; причудливый; шикарный; нравиться; представить
I really fancy – мне реально нравится
I don't fancy – я не представляю; мне не нравится; я не желаю
Acute – острый; серьёзный
Warn – предупреждать
Warning – предупреждение
at last – наконец; в конце концов
wander – бродить; блуждать
for that matter – если на то пошло
It's rather important, as a matter of fact – это довольно важно, на самом деле
Thunder – гром
Adopt – принять; принимать; усыновить
Access modifier – модификатор доступа
Vertex – вершина
Inside – внутрь; изнутри; внутренний
Outside – снаружи; внешний; наружный
Superclass – суперкласс
Subclass – субкласс
Dismiss – увольнять; отклонять; отвергать
Bookmark – закладка
Craft – судно; корабль; ремесло; ремесленный
Aircraft – воздушное судно; самолёт; авиация
Unusual – необычный
Cereal – зерновые; зёрна; хлопья; каша
Impress – впечатлить
Impression – впечатление
Convenient – удобный; удобно
Jogger – бегун
Jogging – бегание; бег; пробежки
Well, I think jogging is good – ну, я думаю, пробежки это хорошо
Cycle – цикл; период; велосипед
Lifecycle – жизненный цикл
Bicycle – велосипед
Cycling – круговорот; езда на велосипеде
Artist – художник; артист
most of all – больше всего
best of all – лучше всего; больше всего
swimming – плавание
throw in the towel – выбросить полотенце; сдаться
whole – целый; полный
hole – дыра; дырка; отверстие
faint – слабый; слабость; потерять сознание
weak – слабый
weakness – слабость
no longer – больше не
eyelids – веки
heavy – тяжёлый
bell – звонок; колокольчик
Okay, you caught me – хорошо, ты впоймал меня
Alright – хорошо; ладно; так
once again – ещё раз; снова
it looks like – это выглядит как; похоже
restate – вновь заявить; повторить
household – домохозяйство
rule number one – правило номер один
kid around – дурачиться
pick up – забрать; взять; подобрать
refrain – воздерживаться
no problem – без проблем
priceless – бесценный
value – стоимость; ценность; значимость; величина; значение; ценить
valuable – ценный; ценность
broken – разбитый; сломанный
foot – нога; ступня; фут
feet – ноги; ступни; футы
Don't listen to him – не слушай его
Sleepy – сонный
you are getting sleepy – ты становишься сонным
just kidding – просто шучу
Cutie – милашка
Act – акт; деяние; действие; поступок; действовать; выступать; поступать
Action – действие; действия; деятельность
Gesture – жест; поступок
Apologize – извиняться; просить прощения
in advance – заранее
I apologize in advance – я заранее извиняюсь
Beforehand – заранее
Kinky – извращённый
Bonnet – шляпка; капот
Under the bonnet – под капотом
To work within a team – работать в команде
advantages of using – преимущества использования
store – магазин; хранение; склад; хранить; сохранять
storing – хранение
restore – восстанавливать
restoring – восстановление
back up – назад; обратно; подкрепить; возвращаться
backup – подкрепление; прикрытие; поддержка; подмога; резервная копия
collaboration – сотрудничество; взаимодействие
branch – отделение; филиал; отрасль; секция; ветка
branching – разветвление
distribute – распространять; распределять
distributed – распределённый
centralized – централизованный
lightweight – лёгкий; лекговесный
remote – отдалённый; удалённый
detach – отсоединить; отделить
detached – отдельный
sandbox – песочница
track – отслеживание; путь; направление; отслеживать; выследить
modify – изменить; модифицировать
comment – комментарий
root – корень; корни; основа; причина; корневой
pay attention – уделять внимание; обратить внимание
existing – существующий; действующий
putting – создание; постановка; уложение
force – сила; силы; усилие; насилие; силовой; заставить; вынудить; принуждать; форсировать
origin – происхождение; принадлежность; истоки; источник
set up – создать; установить; настроить
setup – установка; настройка
stun – оглушить; ошеломить
rapid – быстрый; оперативный; стремительный; скорейший
rapidly – быстро; стремительно; оперативно
brief – краткий; информировать
briefing – брифинг; совещание; информирование; инструктаж
repeat – повторение; повторять
repeatedly – повторно; неоднократно; многократно
less frequent – реже
less frequently – реже
less often – менее часто; реже
fixed price – фиксированная цена
waterfall – водопад
cross-functional – многофункциональный
self-organizing – самоорганизующийся
team – команда
facilitator – посредник; координатор; содействующая сторона
backlog – отставание; задолженности
groom – жених
grooming – ухаживание
refine – совершенствовать; уточнять; доработать
refinement – совершенствование; уточнение; доработка
improve – улучшить; повысить; усовершенствовать
improvement – улучшение; повышение; совершенствование; усовершенствование
perfection – совершенство
enhancement – укрепление; повышение; улучшение; усиление; совершенствование
item – пункт
impede – препятствовать; мешать
impediment – препятствие; помеха
devote – уделять; посвятить
have you ever thought about? – ты когда-нибудь думал о?
Neck – шея
Bottleneck – узкое место; горлышко бутылки
Vision – видение; зрение; концепция; перспектива
target group – целевая группа
engagement – участие; взаимодействие; привлечение; вовлечение; вовлечённость; помолвка; обязательство
without engagement – без обязательств
engaging – участие; взаимодействие; привлечение; вовлечение
broad – широкий; общий; обширный
confirmation – подтверждение; утверждение
negotiable – обсуждаемый
acceptance – принятие; согласие; приёмка
uncertain – неопределённый
uncertainty – неопределённость
mind – разум; ум; мысли; мнение; возражать
monkey – обезьяна; мартышка
revenue – поступления; выручка; доход
margin – разница; запас; прибыль; наценка
gap – разрыв; пробел; зазор; брешь
get behind – встать за; отставать
bake – печь
what if – что если
shoot – стрелять; снимать
shooting – стрельба; съёмка
without warning – без предупреждения
anchor – якорь
continuous – постоянный; непрерывный; продолжающийся
lounge – комната отдыха
retail – розница
maintenance – поддержание; обеспечение; техобслуживание
stare – взгляд; глазеть; пялиться
intruder – нарушитель; злоумышленник
malefactor – злоумышленник
noun – существительное
adjective – прилагательное
adverb – наречие
We apologize for any inconvenience – мы извиняемся за любые неудобства
duration – продолжительность
waste – отходы; трата; растрата; тратить; растрачивать
compliant – соответствующий требованиям
significant – значительный; существенный
grade – класс; оценка
sign up – записаться; подписаться
subscribe – подписаться
unsubscribe – отписаться
subscription – подписка
dream – мечта; мечтать; сниться; грезить
He only dreamt – он только грезил; ему только снилось
that means – это означает
actually – фактически; действительно; в действительности
grant – грант; предоставление; предоставлять; выдавать
They recently granted – они недавно предоставили
He had recently stressed – он недавно подчеркнул
was already over – было уже поздно
workday was already over – рабочий день был уже поздним
beard – борода
after that – после этого
relax – отдых; расслабиться
all in all, he enjoyed a fairly relaxed schedule – в общем, он наслаждался весьма расслабленным графиком
research suggests that – исследование указывает что
disparate – разрозненные; несопоставимые
set out – изложить; излагать; изложенные; поставленные; предусмотренные
invitation – приглашение
Glad too for accepting my invitation – очень рад за принятие поего приглашения
To my regret I cannot accept your invitation – к моему сожалению я не могу принять ваше приглашение
mark – марка; знак; метка; отметка; отмечать
absent – отсутствовать; отсутствующий
accuse – обвинять
shake – пожать; трясти; трястись
confident – уверенный
I felt more confident – я чувствовал себя более уверенным
heaven – небеса
stroke – удар; инсульт
obsessive – навязчивый; одержимый
fighter – боец
dignified – достойный
hazard – опасность; риск
dismissal – увольнение
bluff – блеф; блефовать
break out – сбежать; вырваться
arouse – вызывать
they may arouse concern – они могут вызывать беспокойство
denote – означать; обозначать
tighten – ужесточить
try out – попробовать; испытать
You can try out it within 30 days for free – ты можешь попробовать это в течение 30-ти дней за бесплатно
get around – обойти
to get around this problem – обойти эту проблему
charge – обвинение; плата; заряд; руководство; ответственность; обвинять; взимать; заряжать; поручать
thread-safe – потокобезопасный
accomplished – достигнутый; завершённый